prov,codmunicipio,ambito,censo_20,votantes_20,nulos_20,vlidos_20,blancos_20,votoscand_20,abstenciones_20,eajpnv_20,pp_20,ea_20,ebb_20,pseeepsoe_20,berdeaklv_20,aralar_20,upd_20,share_pse_20,share_ea_20,share_eajpnv_20,share_ebb_20,share_upd_20,share_berdeaklv_20,share_aralar_20,share_pp_20,id
01,059,VITORIA-GASTEIZ,182127,118594,5259,113335,1371,111964,63533,28295,25889,3387,3915,38778,995,4536,5358,.34215379,.029884854,.24965809,.034543611,.047275774,.0087792827,.040022939,.22842899,01059
01,001,ALEGRÍA-DULANTZI,1894,1311,66,1245,14,1231,583,421,168,94,48,379,10,66,36,.30441767,.075502008,.33815262,.038554218,.028915662,.0080321282,.053012047,.13493976,01001
01,003,ARAMAIO,1224,845,189,656,2,654,379,351,6,114,18,39,0,120,4,.059451219,.17378049,.535061,.027439024,.0060975607,0,.18292683,.0091463411,01003
01,006,ARMIÑÓN,179,116,3,113,2,111,63,19,43,6,5,30,1,1,5,.26548672,.053097345,.16814159,.044247787,.044247787,.0088495575,.0088495575,.38053098,01006
01,008,ARRAZUA-UBARRUNDIA,747,496,33,463,4,459,251,207,85,17,18,89,2,23,17,.19222462,.036717061,.44708425,.038876891,.036717061,.0043196543,.049676027,.18358532,01008
01,009,ASPARRENA,1303,838,132,706,7,699,465,337,60,58,21,108,4,103,4,.1529745,.082152978,.47733712,.029745042,.0056657223,.0056657223,.14589235,.084985837,01009
01,011,BAÑOS DE EBRO / MAÑUETA,252,197,2,195,8,187,55,83,65,6,3,27,1,1,0,.13846155,.030769231,.42564103,.015384615,0,.0051282053,.0051282053,.33333334,01011
01,013,BARRUNDIA,683,428,61,367,1,366,255,167,45,17,17,59,6,47,8,.16076294,.046321526,.45504087,.046321526,.021798365,.016348774,.12806539,.12261581,01013
01,014,BERANTEVILLA,394,279,5,274,7,267,115,94,83,3,9,57,4,9,8,.2080292,.010948905,.34306568,.032846715,.02919708,.01459854,.032846715,.30291972,01014
01,016,BERNEDO,481,267,19,248,6,242,214,103,58,9,2,49,2,12,6,.19758065,.036290321,.41532257,.0080645159,.024193548,.0080645159,.048387095,.23387097,01016
01,017,CAMPEZO / KANPEZU,913,569,66,503,1,502,344,231,109,26,20,84,2,17,12,.16699801,.051689859,.45924452,.039761432,.02385686,.003976143,.033797216,.21669979,01017
01,018,ZIGOITIA,1325,893,120,773,9,764,432,327,92,65,25,170,3,53,29,.21992238,.084087968,.42302716,.032341525,.037516169,.0038809832,.068564035,.11901682,01018
01,019,KRIPAN,157,128,3,125,0,125,29,94,21,0,1,7,0,2,0,.056000002,0,.75199997,.0080000004,0,0,.016000001,.168,01019
01,020,KUARTANGO,324,220,34,186,3,183,104,115,19,7,3,20,1,15,2,.10752688,.03763441,.61827958,.016129032,.010752688,.0053763441,.080645159,.10215054,01020
01,021,ELBURGO / BURGELU,409,282,6,276,2,274,127,123,52,10,6,65,0,7,11,.23550725,.036231883,.44565219,.021739131,.039855074,0,.025362318,.1884058,01021
01,022,ELCIEGO,855,611,18,593,4,589,244,134,149,34,14,219,4,13,22,.36930859,.057335582,.22596964,.023608768,.037099496,.0067453627,.021922428,.25126475,01022
01,023,ELVILLAR / BILAR,290,200,5,195,4,191,90,85,61,4,4,32,0,3,1,.16410257,.020512821,.43589744,.020512821,.0051282053,0,.015384615,.31282052,01023
01,027,IRURAIZ-GAUNA,412,257,34,223,11,212,155,98,46,7,5,28,2,23,3,.12556054,.031390134,.43946189,.022421524,.013452915,.0089686103,.10313901,.20627803,01027
01,028,LABASTIDA / BASTIDA,1131,758,44,714,16,698,373,201,219,15,47,159,2,30,24,.22268908,.021008404,.28151262,.065826334,.033613447,.0028011205,.042016808,.3067227,01028
01,030,LAGRÁN,177,125,2,123,1,122,52,43,44,2,2,23,2,3,2,.18699187,.016260162,.34959349,.016260162,.016260162,.016260162,.024390243,.35772356,01030
01,031,LAGUARDIA,1235,890,30,860,12,848,345,298,303,45,19,143,4,14,20,.16627906,.05232558,.34651163,.022093024,.023255814,.0046511628,.01627907,.35232559,01031
01,032,LANCIEGO / LANTZIEGO,547,396,16,380,0,380,151,151,103,14,3,92,2,11,4,.24210526,.036842104,.39736843,.0078947367,.010526316,.0052631581,.028947368,.27105263,01032
01,033,LAPUEBLA DE LABARCA,699,517,14,503,2,501,182,261,99,34,3,90,0,6,6,.17892644,.067594431,.51888669,.0059642149,.01192843,0,.01192843,.19681908,01033
01,034,LEZA,176,131,13,118,2,116,45,50,12,16,1,28,0,5,2,.23728813,.13559322,.42372882,.0084745763,.016949153,0,.042372882,.10169491,01034
01,037,ARRAIA-MAEZTU,608,403,35,368,0,368,205,175,82,14,9,65,3,13,2,.17663044,.038043477,.47554347,.024456521,.0054347827,.0081521738,.035326086,.22282609,01037
01,039,MOREDA DE ÁLAVA,227,183,6,177,3,174,44,49,42,0,2,68,6,3,3,.38418078,0,.27683616,.011299435,.016949153,.033898305,.016949153,.23728813,01039
01,041,NAVARIDAS,160,106,2,104,2,102,54,33,48,3,1,12,0,2,2,.11538462,.028846154,.31730768,.009615385,.01923077,0,.01923077,.46153846,01041
01,043,OYÓN-OION,2320,1321,89,1232,8,1224,999,355,360,23,26,382,4,37,28,.31006494,.01866883,.28814936,.021103896,.022727273,.0032467532,.030032467,.29220778,01043
01,044,PEÑACERRADA-URIZAHARRA,245,186,18,168,2,166,59,64,38,19,8,28,4,3,2,.16666667,.11309524,.38095239,.047619049,.011904762,.023809524,.017857144,.22619048,01044
01,046,ERRIBERA GOITIA / RIBERA ALTA,602,404,19,385,4,381,198,151,87,13,15,77,1,19,17,.2,.033766232,.3922078,.038961038,.044155844,.0025974025,.049350649,.22597402,01046
01,047,RIBERA BAJA / ERRIBERA BEITIA,879,581,15,566,6,560,298,158,161,5,15,178,5,8,23,.31448764,.0088339224,.27915195,.026501767,.040636044,.0088339224,.014134276,.28445229,01047
01,049,AÑANA,158,127,8,119,5,114,31,54,26,7,1,20,0,5,0,.16806723,.05882353,.45378152,.0084033618,0,0,.042016808,.2184874,01049
01,051,SALVATIERRA / AGURAIN,3642,2089,316,1773,18,1755,1553,787,214,93,55,417,7,152,25,.23519458,.052453469,.44388044,.031020869,.014100395,.0039481106,.085730404,.12069938,01051
01,052,SAMANIEGO,234,189,12,177,0,177,45,91,12,2,7,50,0,9,4,.28248587,.011299435,.51412427,.039548021,.02259887,0,.050847456,.06779661,01052
01,053,SAN MILLÁN / DONEMILIAGA,611,334,45,289,2,287,277,175,36,9,16,25,1,23,2,.08650519,.031141868,.60553634,.055363324,.0069204154,.0034602077,.079584777,.12456747,01053
01,054,URKABUSTAIZ,897,595,130,465,5,460,302,227,47,28,19,103,4,27,4,.22150537,.060215052,.48817205,.040860213,.0086021507,.0086021507,.058064517,.10107527,01054
01,055,VALDEGOVÍA / GAUBEA,935,652,30,622,7,615,283,257,160,9,19,131,4,24,8,.21061093,.014469453,.41318327,.030546624,.012861736,.0064308681,.038585208,.25723472,01055
01,056,HARANA / VALLE DE ARANA,279,190,11,179,1,178,89,113,24,1,3,30,0,6,1,.16759777,.005586592,.63128489,.016759777,.005586592,0,.033519555,.13407822,01056
01,057,VILLABUENA DE ÁLAVA / ESKUERNAGA,269,211,23,188,2,186,58,113,36,13,3,14,0,4,3,.074468084,.069148935,.60106385,.015957447,.015957447,0,.021276595,.19148937,01057
01,058,LEGUTIANO,1263,779,131,648,5,643,484,282,49,78,26,144,3,55,3,.22222222,.12037037,.43518519,.040123455,.0046296297,.0046296297,.084876545,.075617284,01058
01,060,YÉCORA / IEKORA,236,170,4,166,4,162,66,68,65,0,3,18,0,4,4,.10843374,0,.40963855,.018072288,.024096385,0,.024096385,.39156628,01060
01,061,ZALDUONDO,158,123,15,108,3,105,35,58,5,3,9,20,2,6,2,.18518518,.027777778,.53703701,.083333336,.018518519,.018518519,.055555556,.046296295,01061
01,062,ZAMBRANA,318,212,5,207,1,206,106,79,59,3,6,42,2,5,8,.20289855,.014492754,.38164252,.028985508,.038647342,.0096618356,.024154589,.28502417,01062
01,063,ZUIA,1727,1246,102,1144,16,1128,481,550,158,52,20,212,14,79,34,.18531469,.045454547,.48076922,.017482517,.02972028,.012237762,.069055945,.13811189,01063
01,901,IRUÑA OKA / IRUÑA DE OCA,2196,1427,39,1388,29,1359,769,372,332,17,33,465,17,56,52,.3350144,.012247839,.26801154,.023775216,.037463978,.012247839,.040345822,.23919308,01901
01,902,LANTARÓN,812,517,17,500,6,494,295,180,145,6,30,89,12,18,12,.178,.012,.36000001,.059999999,.024,.024,.035999998,.28999999,01902
01,002,AMURRIO,8137,5840,484,5356,54,5302,2297,2755,531,358,179,1108,31,278,43,.20687079,.066840924,.5143764,.033420462,.0080283796,.0057879016,.051904406,.099141151,01002
01,004,ARTZINIEGA,1453,1048,84,964,7,957,405,450,136,36,24,185,11,98,12,.19190872,.0373444,.46680498,.024896266,.012448133,.011410789,.10165975,.14107884,01004
01,010,AYALA / AIARA,2219,1677,125,1552,18,1534,542,885,182,120,36,209,9,77,10,.13466495,.077319585,.57023197,.023195876,.0064432989,.005798969,.049613401,.11726804,01010
01,036,LAUDIO / LLODIO,15358,10445,1026,9419,97,9322,4913,4500,1189,273,257,2482,43,441,88,.26350993,.028983969,.47775772,.027285274,.0093428176,.0045652403,.046820257,.1262342,01036
01,042,OKONDO,878,679,92,587,2,585,199,352,50,99,6,34,3,34,2,.057921637,.16865417,.59965926,.010221465,.0034071549,.0051107327,.057921637,.085178874,01042
01,999,MUNICIPIO CERA ARABA,3476,436,3,433,1,432,3040,146,83,6,16,140,13,7,12,.32332563,.013856813,.33718246,.036951501,.027713627,.030023094,.016166281,.19168591,01999
20,040,HERNANI,15249,8814,2494,6320,102,6218,6435,2092,512,326,297,1992,43,845,88,.31518987,.051582277,.33101267,.046993669,.013924051,.0068037976,.13370253,.081012659,20040
20,069,DONOSTIA-SAN SEBASTIÁN,147257,93007,8119,84888,1259,83629,54250,24187,13757,3648,2909,28569,469,6885,2874,.33654934,.042974271,.28492838,.034268685,.033856377,.0055249268,.081106871,.1620606,20069
20,072,URNIETA,4652,2689,297,2392,34,2358,1963,828,193,69,86,875,9,251,40,.36580268,.028846154,.34615386,.035953179,.016722407,.0037625418,.10493311,.080685616,20072
20,073,USURBIL,4669,2921,768,2153,23,2130,1748,895,126,132,82,477,10,373,16,.22155133,.0613098,.41569903,.038086392,.0074314908,.0046446817,.17324664,.058522992,20073
20,902,LASARTE-ORIA,14275,9134,817,8317,105,8212,5141,2092,991,226,279,3816,59,528,175,.4588193,.02717326,.251533,.033545751,.021041241,.0070939041,.06348443,.11915354,20902
20,903,ASTIGARRAGA,3513,1986,449,1537,22,1515,1527,643,104,107,60,344,9,217,29,.22381262,.069616139,.41834742,.039037086,.018867925,.0058555626,.14118412,.067664281,20903
20,036,HONDARRIBIA,12782,8130,755,7375,118,7257,4652,3526,591,445,237,1592,33,700,112,.21586441,.060338981,.4781017,.032135595,.015186441,.0044745761,.094915256,.080135591,20036
20,045,IRUN,47090,28772,1497,27275,375,26900,18318,7365,4006,610,1058,11539,186,1331,682,.4230614,.022364803,.27002749,.038790099,.025004582,.0068194317,.048799265,.14687443,20045
20,053,LEZO,4853,2557,776,1781,37,1744,2296,733,112,61,57,515,5,230,24,.28916338,.03425042,.41156653,.03200449,.013475575,.0028074116,.12914093,.062886022,20053
20,063,OIARTZUN,7854,4786,1787,2999,36,2963,3068,1510,174,239,122,384,14,491,25,.12804268,.079693228,.50350118,.040680226,.0083361119,.0046682227,.16372123,.05801934,20063
20,064,PASAIA,12577,6739,1288,5451,85,5366,5838,1790,592,299,252,1862,29,443,75,.34158871,.054852322,.32838011,.046230048,.013758943,.0053201248,.081269495,.10860392,20064
20,067,ERRENTERIA,31419,18129,2503,15626,175,15451,13290,4236,1515,525,739,6781,135,1160,292,.43395624,.033597849,.27108666,.047292974,.018686805,.0086394474,.074235246,.096953794,20067
20,001,ABALTZISKETA,242,139,37,102,4,98,103,65,1,8,6,0,0,18,0,0,.078431375,.63725489,.05882353,0,0,.17647059,.0098039219,20001
20,002,ADUNA,310,193,74,119,0,119,117,59,2,11,5,5,0,36,0,.042016808,.092436977,.49579832,.042016808,0,0,.30252102,.016806724,20002
20,004,ALBIZTUR,255,144,10,134,6,128,111,85,1,10,0,10,0,22,0,.074626863,.074626863,.63432837,0,0,0,.1641791,.0074626864,20004
20,005,ALEGIA,1356,835,209,626,4,622,521,339,26,55,19,71,1,110,0,.11341853,.087859422,.54153353,.030351438,0,.0015974441,.17571884,.041533545,20005
20,006,ALKIZA,277,159,19,140,4,136,118,95,0,3,3,0,0,33,1,0,.021428572,.6785714,.021428572,.0071428572,0,.23571429,0,20006
20,007,ALTZO,300,177,61,116,2,114,123,66,1,9,0,4,1,33,0,.034482758,.077586204,.56896549,0,0,.0086206896,.28448275,.0086206896,20007
20,008,AMEZKETA,765,453,124,329,8,321,312,199,9,38,8,6,1,60,0,.018237082,.11550152,.60486323,.02431611,0,.0030395137,.18237083,.027355623,20008
20,009,ANDOAIN,11969,7382,948,6434,62,6372,4587,2012,607,297,313,2417,39,574,84,.37566054,.046161018,.31271371,.04864781,.013055642,.0060615479,.08921355,.094342552,20009
20,010,ANOETA,1400,891,268,623,7,616,509,282,47,46,19,127,1,93,1,.20385233,.073836274,.45264846,.030497592,.0016051364,.0016051364,.14927769,.075441413,20010
20,012,ARAMA,154,105,32,73,0,73,49,39,3,7,0,6,0,15,1,.08219178,.09589041,.53424656,0,.01369863,0,.20547946,.04109589,20012
20,014,ASTEASU,1119,639,180,459,4,455,480,228,14,103,16,24,0,70,0,.052287582,.22440088,.49673203,.034858387,0,0,.15250544,.03050109,20014
20,015,ATAUN,1350,1015,411,604,2,602,335,408,0,47,12,24,2,109,0,.039735101,.077814572,.6754967,.019867551,0,.0033112583,.18046358,0,20015
20,019,BEASAIN,10182,6571,719,5852,80,5772,3611,2394,396,343,174,1768,30,608,35,.30211893,.05861244,.40909091,.029733425,.0059808614,.0051264525,.1038961,.067669176,20019
20,021,BELAUNTZA,240,120,31,89,0,89,120,54,3,5,1,9,0,16,1,.10112359,.056179777,.60674155,.011235955,.011235955,0,.17977528,.033707865,20021
20,022,BERASTEGI,818,510,92,418,5,413,308,278,5,42,8,17,3,58,0,.040669855,.10047847,.66507179,.019138755,0,.0071770335,.13875598,.011961723,20022
20,023,BERROBI,464,275,65,210,0,210,189,120,9,5,16,25,2,30,2,.11904762,.023809524,.5714286,.076190479,.0095238099,.0095238099,.14285715,.042857144,20023
20,025,ZEGAMA,1159,812,191,621,6,615,347,302,3,200,10,21,0,78,0,.033816423,.32206118,.48631239,.016103059,0,0,.12560387,.0048309178,20025
20,026,ZERAIN,206,158,53,105,0,105,48,83,1,3,1,1,0,16,0,.0095238099,.028571429,.7904762,.0095238099,0,0,.15238096,.0095238099,20026
20,028,ZIZURKIL,2183,1297,308,989,8,981,886,442,59,53,33,267,6,111,8,.26996967,.053589486,.44691607,.033367038,.0080889789,.006066734,.11223458,.059656218,20028
20,031,ELDUAIN,188,123,55,68,1,67,65,48,0,5,2,3,1,8,0,.044117648,.073529415,.70588237,.029411765,0,.014705882,.11764706,0,20031
20,035,EZKIO-ITSASO,461,323,113,210,2,208,138,119,1,25,2,4,1,55,1,.01904762,.11904762,.56666666,.0095238099,.0047619049,.0047619049,.26190478,.0047619049,20035
20,037,GAINTZA,112,69,19,50,1,49,43,34,0,3,5,0,0,7,0,0,.059999999,.68000001,.1,0,0,.14,0,20037
20,038,GABIRIA,362,268,52,216,3,213,94,113,2,58,1,6,1,32,0,.027777778,.26851851,.52314812,.0046296297,0,.0046296297,.14814815,.0092592593,20038
20,041,HERNIALDE,275,145,29,116,2,114,130,73,3,8,4,6,0,17,2,.05172414,.068965517,.62931037,.034482758,.017241379,0,.14655173,.02586207,20041
20,042,IBARRA,3480,2023,454,1569,22,1547,1457,657,98,108,49,401,6,214,10,.25557679,.068833649,.41873804,.031230083,.0063734865,.0038240917,.13639261,.062460165,20042
20,043,IDIAZABAL,1777,1229,219,1010,12,998,548,551,39,165,10,73,4,153,2,.072277226,.16336633,.54554456,.0099009899,.0019801981,.0039603962,.15148515,.03861386,20043
20,044,IKAZTEGIETA,353,222,84,138,3,135,131,91,4,3,2,12,1,21,0,.086956523,.021739131,.65942031,.014492754,0,.0072463769,.15217391,.028985508,20044
20,046,IRURA,1093,662,142,520,10,510,431,273,22,36,10,83,1,80,2,.15961538,.069230773,.52499998,.01923077,.0038461538,.0019230769,.15384616,.042307694,20046
20,047,ITSASONDO,510,321,113,208,0,208,189,112,6,9,4,32,2,43,0,.15384616,.043269232,.53846157,.01923077,0,.009615385,.20673077,.028846154,20047
20,048,LARRAUL,179,100,34,66,1,65,79,33,0,6,2,7,2,15,0,.10606061,.090909094,.5,.030303031,0,.030303031,.22727273,0,20048
20,049,LAZKAO,4094,2679,549,2130,33,2097,1415,913,114,157,62,616,13,213,7,.28920189,.073708922,.42863849,.02910798,.003286385,.0061032865,.1,.053521127,20049
20,050,LEABURU,310,198,93,105,1,104,112,80,3,5,0,2,0,14,0,.01904762,.047619049,.76190478,0,0,0,.13333334,.028571429,20050
20,051,LEGAZPI,7162,4767,573,4194,38,4156,2395,1695,319,290,165,1114,15,526,22,.26561755,.069146402,.40414879,.039341915,.0052455887,.0035765378,.12541726,.07606104,20051
20,052,LEGORRETA,1171,794,196,598,5,593,377,320,33,18,23,123,0,74,1,.20568562,.030100334,.53511703,.03846154,.0016722408,0,.12374582,.055183947,20052
20,054,LIZARTZA,498,345,205,140,5,135,153,88,13,7,2,3,0,22,0,.021428572,.050000001,.62857145,.014285714,0,0,.15714286,.092857145,20054
20,057,MUTILOA,188,104,28,76,0,76,84,51,0,1,2,3,1,18,0,.039473683,.013157895,.67105263,.02631579,0,.013157895,.23684211,0,20057
20,058,OLABERRIA,783,551,74,477,5,472,232,186,47,20,9,156,4,46,3,.32704404,.04192872,.3899371,.018867925,.006289308,.0083857439,.096436061,.098532498,20058
20,060,OREXA,95,80,70,10,4,6,15,5,0,0,0,0,0,1,0,0,0,.5,0,0,0,.1,0,20060
20,062,ORMAIZTEGI,1017,718,148,570,6,564,299,327,32,24,20,65,0,88,3,.11403508,.042105265,.57368422,.03508772,.0052631581,0,.15438597,.056140352,20062
20,070,SEGURA,1084,764,207,557,8,549,320,316,11,102,7,19,6,88,0,.03411131,.18312387,.56732494,.012567325,0,.010771993,.15798923,.019748654,20070
20,071,TOLOSA,14385,8705,1364,7341,81,7260,5680,3457,577,457,259,1409,20,1002,49,.1919357,.062253099,.47091678,.035281297,.0066748401,.0027244245,.13649367,.078599647,20071
20,075,VILLABONA,4506,2633,628,2005,39,1966,1873,888,150,102,61,452,9,275,24,.2254364,.050872818,.44289276,.030423939,.011970075,.0044887778,.13715711,.074812971,20075
20,076,ORDIZIA,7015,4595,775,3820,40,3780,2420,1452,283,226,158,1107,21,493,30,.28979057,.059162304,.38010472,.041361257,.0078534028,.005497382,.12905759,.074083768,20076
20,077,URRETXU,5453,3809,495,3314,39,3275,1644,1311,227,272,108,990,14,329,13,.29873264,.082076043,.39559445,.032589015,.0039227521,.004224502,.099275798,.068497285,20077
20,078,ZALDIBIA,1180,864,391,473,4,469,316,224,16,10,10,56,0,153,0,.11839323,.021141648,.47357294,.021141648,0,0,.32346722,.033826638,20078
20,080,ZUMARRAGA,8155,5496,455,5041,65,4976,2659,1581,456,254,188,2079,22,342,30,.41241816,.050386827,.31362826,.037294187,.0059512001,.0043642134,.067843683,.090458244,20080
20,904,BALIARRAIN,87,55,29,26,0,26,32,19,0,1,0,0,1,5,0,0,.03846154,.73076922,0,0,.03846154,.1923077,0,20904
20,905,ORENDAIN,151,101,38,63,0,63,50,39,0,9,1,0,0,14,0,0,.14285715,.61904764,.015873017,0,0,.22222222,0,20905
20,906,ALTZAGA,120,92,31,61,0,61,28,39,0,1,1,7,1,11,0,.1147541,.016393442,.63934427,.016393442,0,.016393442,.18032786,0,20906
20,907,GAZTELU,137,92,39,53,0,53,45,36,1,1,0,3,0,12,0,.056603774,.018867925,.67924529,0,0,0,.2264151,.018867925,20907
20,003,AIZARNAZABAL,502,277,86,191,5,186,225,119,0,8,2,10,1,45,0,.05235602,.041884817,.62303662,.010471204,0,.0052356021,.2356021,0,20003
20,011,ANTZUOLA,1734,1264,363,901,7,894,470,426,22,58,28,190,0,169,1,.21087681,.064372919,.472808,.031076582,.001109878,0,.18756936,.024417315,20011
20,013,ARETXABALETA,5326,3494,649,2845,15,2830,1832,1114,138,239,129,657,20,521,8,.23093146,.084007032,.39156416,.045342706,.0028119509,.007029877,.1831283,.048506152,20013
20,016,AIA,1483,910,127,783,1,782,573,597,6,52,13,20,2,91,0,.025542784,.066411242,.76245213,.01660281,0,.0025542784,.11621967,.0076628351,20016
20,017,AZKOITIA,8735,5784,730,5054,35,5019,2951,2667,283,190,113,938,19,780,21,.18559557,.037593983,.52770084,.022358527,.0041551245,.0037593986,.1543332,.055995252,20017
20,018,AZPEITIA,11105,7463,1359,6104,38,6066,3642,3894,231,400,93,581,8,835,14,.095183484,.065530799,.63794231,.015235911,.0022935779,.001310616,.13679555,.037844036,20018
20,020,BEIZAMA,146,96,30,66,0,66,50,49,0,5,1,1,1,8,1,.015151516,.075757578,.74242425,.015151516,.015151516,.015151516,.12121212,0,20020
20,024,BIDEGOIAN,382,221,43,178,5,173,161,99,8,31,1,6,0,27,0,.033707865,.17415731,.55617976,.0056179776,0,0,.15168539,.044943821,20024
20,027,ZESTOA,2762,1796,429,1367,10,1357,966,795,21,138,40,108,5,243,4,.079005122,.10095099,.5815655,.029261155,.0029261156,.0036576444,.17776152,.015362107,20027
20,029,DEBA,4321,2952,495,2457,35,2422,1369,1111,110,330,118,347,15,369,15,.14122914,.13431014,.45217746,.048026048,.0061050062,.0061050062,.15018316,.044770043,20029
20,030,EIBAR,22628,14994,1244,13750,157,13593,7634,4887,1337,533,538,5032,70,1038,118,.36596364,.038763635,.35541818,.039127272,.0085818181,.0050909091,.075490907,.097236365,20030
20,032,ELGOIBAR,8990,6091,702,5389,38,5351,2899,2406,427,306,168,1462,35,508,23,.27129337,.056782335,.44646502,.031174615,.0042679533,.0064947116,.094266094,.079235479,20032
20,033,ELGETA,846,603,133,470,3,467,243,256,16,17,13,34,0,129,2,.072340429,.036170214,.54468083,.027659575,.004255319,0,.27446809,.034042552,20033
20,034,ESKORIATZA,3270,1992,324,1668,8,1660,1278,676,86,117,69,504,11,180,13,.30215827,.070143886,.40527579,.041366905,.007793765,.006594724,.10791367,.051558752,20034
20,039,GETARIA,2018,1492,324,1168,7,1161,526,757,23,86,29,63,2,200,1,.053938355,.073630139,.64811641,.024828767,.00085616438,.0017123288,.17123288,.01969178,20039
20,055,ARRASATE / MONDRAGON,18166,11615,1921,9694,84,9610,6551,3349,786,589,606,3028,48,1119,66,.31235817,.060759231,.34547141,.062512897,.006808335,.0049515166,.11543223,.081081077,20055
20,056,MUTRIKU,3984,2472,500,1972,28,1944,1512,1254,86,108,38,164,55,230,8,.083164297,.054766733,.63590264,.019269777,.004056795,.027890466,.11663286,.043610547,20056
20,059,OÑATI,8769,5900,946,4954,40,4914,2869,2528,253,326,223,612,10,950,7,.12353653,.065805413,.51029474,.045014132,.0014129996,.0020185709,.19176424,.051069841,20059
20,061,ORIO,3862,2566,353,2213,15,2198,1296,1334,59,116,70,288,10,310,5,.13014008,.052417532,.60280162,.031631269,.0022593765,.0045187529,.14008133,.026660642,20061
20,065,SORALUZE-PLACENCIA DE LAS ARMAS,3255,2141,367,1774,16,1758,1114,623,194,145,44,567,6,166,11,.31961668,.081736192,.35118377,.024802705,.0062006763,.0033821871,.093573846,.10935739,20065
20,066,ERREZIL,483,281,119,162,1,161,202,134,3,2,1,6,0,15,0,.037037037,.012345679,.82716048,.0061728396,0,0,.09259259,.018518519,20066
20,068,LEINTZ-GATZAGA,207,131,46,85,0,85,76,66,1,3,3,2,0,10,0,.023529412,.035294119,.7764706,.035294119,0,0,.11764706,.011764706,20068
20,074,BERGARA,11891,7633,1358,6275,45,6230,4258,2866,300,288,312,1290,29,1117,18,.20557769,.045896415,.45673308,.049721114,.0028685259,.0046215141,.17800798,.047808766,20074
20,079,ZARAUTZ,17187,11549,1314,10235,126,10109,5638,4217,831,817,324,2284,42,1476,97,.22315584,.079824135,.41201758,.031656083,.0094772838,.0041035661,.14421104,.081191987,20079
20,081,ZUMAIA,7260,4736,674,4062,45,4017,2524,1704,189,445,132,982,21,509,26,.24175283,.10955194,.41949779,.032496307,.0064007877,.0051698671,.12530772,.046528805,20081
20,901,MENDARO,1489,982,83,899,14,885,507,460,30,48,17,208,3,113,4,.23136818,.05339266,.51167965,.0189099,.004449388,.0033370412,.12569521,.033370413,20901
20,999,MUNICIPIO CERA GIPUZKOA,16863,3208,105,3103,12,3091,13655,1135,366,133,126,951,62,189,100,.30647761,.042861748,.36577505,.040605865,.032226875,.019980663,.060908798,.11795037,20999
48,020,BILBAO,281807,188845,8572,180273,1917,178356,92962,64830,33669,3226,6161,57425,911,6245,4207,.31854466,.017895082,.35962123,.034175944,.023336828,.0050534466,.034641903,.18676674,48020
48,002,ABANTO Y CIÉRVANA-ABANTO ZIERBENA,7938,5156,350,4806,64,4742,2782,2212,264,109,251,1628,37,145,48,.33874324,.022679983,.46025801,.052226383,.0099875154,.0076987101,.030170619,.054931335,48002
48,008,ARTZENTALES,600,443,36,407,4,403,157,312,14,6,10,32,3,25,1,.078624077,.014742015,.76658475,.024570024,.0024570024,.0073710075,.06142506,.034398034,48008
48,013,BARAKALDO,81803,51187,2140,49047,554,48493,30616,14209,7612,826,2044,20963,230,1069,1048,.42740637,.016840989,.2897017,.041674312,.021367259,.0046893796,.02179542,.15519808,48013
48,022,KARRANTZA HARANA / VALLE DE CARRANZA,2430,1590,105,1485,16,1469,840,1046,74,38,48,193,0,58,3,.12996633,.025589226,.70437711,.032323234,.0020202021,0,.03905724,.049831651,48022
48,037,GALDAMES,715,541,62,479,3,476,174,313,17,46,16,48,1,27,3,.10020877,.096033402,.65344465,.033402923,.0062630479,.0020876827,.056367431,.035490606,48037
48,042,GORDEXOLA,1418,1180,39,1141,9,1132,238,657,127,63,45,171,4,35,21,.14986853,.055214725,.57581067,.03943909,.018404908,.0035056968,.030674847,.11130587,48042
48,045,GÜEÑES,5061,3961,326,3635,23,3612,1100,2094,197,199,96,755,15,169,61,.20770289,.054745529,.57606602,.026409904,.016781293,.0041265474,.046492435,.054195322,48045
48,051,LANESTOSA,240,174,4,170,0,170,66,96,19,3,2,37,0,6,5,.21764706,.01764706,.56470591,.011764706,.029411765,0,.035294119,.11176471,48051
48,071,MUSKIZ,5972,4302,320,3982,44,3938,1670,1923,200,314,171,1072,15,183,22,.26921144,.078854844,.48292315,.042943243,.0055248621,.0037669514,.045956805,.050226018,48071
48,078,PORTUGALETE,40796,26678,1113,25565,264,25301,14118,8257,3562,363,1169,10578,110,555,494,.41376883,.0141991,.32298064,.045726579,.019323293,.0043027578,.021709368,.13933112,48078
48,080,VALLE DE TRÁPAGA-TRAPAGARAN,10388,6905,416,6489,59,6430,3483,2637,478,84,275,2598,29,185,90,.40036985,.012944984,.40638003,.042379413,.013869626,.0044691018,.028509786,.073663123,48080
48,082,SANTURTZI,38990,24628,1414,23214,230,22984,14362,8876,2763,316,950,8940,83,509,354,.38511243,.013612475,.38235548,.040923581,.015249418,.0035754286,.021926424,.119023,48082
48,083,ORTUELLA,7166,4799,233,4566,40,4526,2367,2044,235,144,178,1683,15,124,56,.36859396,.031537451,.4476566,.038983792,.012264565,.0032851512,.027157249,.051467367,48083
48,084,SESTAO,24456,14729,765,13964,146,13818,9727,4551,1711,223,744,5906,53,292,190,.42294472,.015969636,.3259095,.053279862,.013606416,.0037954741,.020910913,.12252936,48084
48,086,SOPUERTA,2058,1435,80,1355,18,1337,623,717,92,202,40,207,6,58,14,.15276752,.14907749,.52915132,.029520296,.010332103,.0044280444,.042804427,.067896679,48086
48,087,TRUCIOS-TURTZIOZ,455,345,13,332,0,332,110,217,22,10,0,52,0,27,3,.15662651,.030120483,.65361446,0,.0090361442,0,.0813253,.066265061,48087
48,090,BALMASEDA,6008,4593,257,4336,32,4304,1415,2251,296,191,90,1292,7,100,43,.29797047,.044049814,.51914209,.020756457,.0099169742,.0016143911,.02306273,.068265684,48090
48,096,ZALLA,6581,5180,293,4887,54,4833,1401,3013,251,158,131,998,21,206,25,.20421526,.032330673,.61653364,.026805811,.0051156129,.0042971149,.042152651,.051360752,48096
48,912,ALONSOTEGI,2374,1752,171,1581,16,1565,622,811,110,117,36,404,6,60,13,.25553447,.074003793,.51296645,.022770399,.0082226442,.0037950664,.037950665,.069576219,48912
48,913,ZIERBENA,1177,900,94,806,8,798,277,527,26,12,23,160,9,36,2,.19851117,.014888338,.65384614,.028535981,.0024813896,.011166253,.044665013,.032258064,48913
48,001,ABADIÑO,5857,3765,594,3171,25,3146,2092,1301,365,73,100,970,13,273,11,.30589721,.02302113,.41028067,.031535793,.0034689372,.0040996531,.086092718,.11510564,48001
48,003,AMOREBIETA-ETXANO,14093,9820,1275,8545,64,8481,4273,4314,530,334,400,2150,39,575,69,.25160912,.039087184,.50485665,.046811,.0080748973,.0045640725,.067290813,.062024575,48003
48,005,ARAKALDO,79,53,13,40,3,37,26,25,2,0,0,6,0,4,0,.15000001,0,.625,0,0,0,.1,.050000001,48005
48,006,ARANTZAZU,253,211,40,171,2,169,42,108,7,12,3,9,1,29,0,.052631579,.070175439,.63157892,.01754386,0,.0058479533,.16959064,.040935673,48006
48,009,ARRANKUDIAGA,751,577,128,449,3,446,174,336,21,14,9,26,1,33,5,.05790646,.0311804,.74832964,.020044543,.011135858,.0022271716,.073496662,.046770602,48009
48,011,ARRIGORRIAGA,9733,6422,479,5943,70,5873,3311,2557,547,163,248,1858,35,270,128,.3126367,.027427224,.43025407,.041729767,.021537945,.0058892816,.045431599,.09204106,48011
48,015,BASAURI,36013,23928,1099,22829,214,22615,12085,8366,2885,348,760,8875,87,701,351,.38875991,.015243769,.36646372,.03329099,.015375181,.0038109422,.030706558,.12637435,48015
48,019,BERRIZ,3869,2559,333,2226,25,2201,1310,1008,185,76,60,611,6,202,23,.27448338,.034141958,.4528302,.026954178,.010332434,.0026954177,.090745732,.083108716,48019
48,023,ARTEA,613,500,84,416,7,409,113,230,20,84,3,15,1,52,2,.036057692,.20192307,.55288464,.0072115385,.0048076925,.0024038462,.125,.048076924,48023
48,024,ZEANURI,1057,829,143,686,3,683,228,489,15,58,5,33,0,77,2,.048104957,.084548108,.71282798,.0072886297,.002915452,0,.1122449,.021865889,48024
48,025,ZEBERIO,864,628,140,488,5,483,236,379,7,9,10,29,2,42,1,.059426229,.018442623,.77663934,.020491803,.0020491802,.0040983604,.086065575,.014344262,48025
48,026,DIMA,1057,836,232,604,4,600,221,472,11,22,8,10,1,72,3,.016556291,.03642384,.78145695,.013245033,.0049668876,.0016556291,.1192053,.01821192,48026
48,027,DURANGO,21633,14806,1490,13316,110,13206,6827,5898,1529,287,468,3339,45,1387,152,.25075099,.021553019,.44292581,.035145689,.011414839,.0033793931,.10416041,.11482427,48027
48,029,ETXEBARRI,7313,4684,188,4496,43,4453,2629,1395,565,116,176,1887,46,119,105,.4197064,.025800712,.31027579,.039145909,.023354093,.010231317,.026467972,.12566726,48029
48,032,ELORRIO,5903,3994,796,3198,18,3180,1909,1488,301,105,84,725,9,431,13,.2267042,.032833021,.46529081,.026266417,.0040650405,.0028142589,.13477173,.094121329,48032
48,034,ERMUA,13317,8845,275,8570,72,8498,4472,1755,1742,106,366,3888,54,340,155,.4536756,.012368728,.20478413,.042707119,.018086348,.0063010501,.03967328,.20326722,48034
48,036,GALDAKAO,24107,16017,1206,14811,129,14682,8090,6551,1465,476,638,4348,70,771,234,.2935656,.032138277,.4423064,.043076091,.015799068,.0047262171,.052055903,.098912969,48036
48,039,GARAI,255,205,37,168,2,166,50,122,4,4,0,10,0,25,1,.05952381,.023809524,.72619045,0,.0059523811,0,.14880952,.023809524,48039
48,050,IZURTZA,225,168,57,111,1,110,57,91,2,4,1,5,1,5,0,.045045044,.036036037,.81981981,.0090090092,0,.0090090092,.045045044,.018018018,48050
48,055,LEMOA,2510,1910,283,1627,25,1602,600,908,93,139,54,278,7,102,10,.17086662,.085433312,.55808234,.033189919,.0061462815,.0043023969,.062692069,.057160418,48055
48,058,MALLABIA,988,641,178,463,2,461,347,271,27,17,8,96,3,37,2,.20734341,.036717061,.5853132,.017278617,.0043196543,.0064794817,.079913609,.058315333,48058
48,059,MAÑARIA,383,296,76,220,1,219,87,163,5,10,4,12,0,24,0,.054545455,.045454547,.7409091,.018181818,0,0,.10909091,.022727273,48059
48,065,UGAO-MIRABALLES,3316,2251,301,1950,15,1935,1065,1033,172,85,66,423,8,96,27,.21692307,.043589745,.52974361,.033846155,.013846153,.004102564,.049230769,.088205129,48065
48,072,OTXANDIO,996,746,236,510,1,509,250,329,32,29,15,41,0,61,2,.08039216,.056862745,.64509803,.029411765,.0039215689,0,.11960784,.062745102,48072
48,074,URDUÑA/ORDUÑA,3406,2402,333,2069,15,2054,1004,1064,221,95,73,384,13,153,25,.18559691,.045915902,.51425809,.035282746,.012083132,.0062832288,.073948771,.10681488,48074
48,075,OROZKO,1892,1422,138,1284,5,1279,470,923,97,62,17,84,1,82,5,.065420561,.048286606,.71884733,.013239875,.0038940811,.00077881617,.063862927,.075545169,48075
48,088,UBIDE,131,97,38,59,0,59,34,42,7,1,2,2,0,5,0,.033898305,.016949153,.71186441,.033898305,0,0,.084745765,.11864407,48088
48,091,ATXONDO,1203,821,204,617,9,608,382,376,27,10,14,118,0,62,0,.19124797,.016207455,.60940033,.022690438,0,0,.10048623,.043760128,48091
48,092,BEDIA,783,604,57,547,6,541,179,388,30,10,12,66,1,23,7,.12065814,.018281536,.70932359,.021937843,.012797075,.0018281536,.04204753,.054844607,48092
48,093,AREATZA,843,653,87,566,4,562,190,343,54,16,10,55,2,72,3,.097173147,.028268551,.60600704,.017667845,.0053003533,.0035335689,.12720849,.095406361,48093
48,094,IGORRE,3382,2400,445,1955,17,1938,982,1293,64,114,36,198,5,195,15,.10127877,.058312021,.66138107,.018414322,.0076726344,.0025575447,.099744245,.032736573,48094
48,095,ZALDIBAR,2378,1522,214,1308,13,1295,856,519,164,49,32,423,3,71,16,.32339451,.037461773,.39678898,.024464833,.012232416,.0022935779,.054281346,.12538226,48095
48,097,ZARATAMO,1406,959,95,864,8,856,447,448,61,52,16,212,4,48,8,.24537037,.060185187,.51851851,.018518519,.0092592593,.0046296297,.055555556,.070601851,48097
48,910,IURRETA,3140,2051,293,1758,15,1743,1089,753,222,23,52,537,7,119,13,.30546075,.013083049,.42832765,.029579068,.0073947669,.0039817975,.067690559,.12627986,48910
48,004,AMOROTO,324,233,32,201,1,200,91,159,0,10,1,0,2,28,0,0,.049751244,.79104477,.0049751243,0,.0099502485,.13930348,0,48004
48,007,MUNITIBAR-ARBATZEGI GERRIKAITZ-,347,249,2,247,65,182,98,152,4,3,1,4,0,18,0,.016194332,.012145749,.61538464,.0040485831,0,0,.072874494,.016194332,48007
48,010,ARRIETA,446,315,27,288,1,287,131,217,2,18,6,12,2,27,1,.041666668,.0625,.75347221,.020833334,.0034722222,.0069444445,.09375,.0069444445,48010
48,012,BAKIO,1862,1517,190,1327,6,1321,345,869,40,136,30,99,14,112,10,.07460437,.10248681,.65486062,.022607384,.0075357952,.010550113,.084400907,.030143181,48012
48,014,BARRIKA,1151,806,83,723,10,713,345,391,52,68,23,106,6,54,8,.14661135,.094052561,.54080224,.031811897,.011065007,.0082987556,.0746888,.071922548,48014
48,016,BERANGO,5054,3597,362,3235,32,3203,1457,1393,411,122,104,907,19,141,81,.28037095,.037712518,.43060279,.032148376,.025038639,.005873261,.043585781,.12704791,48016
48,017,BERMEO,13632,9525,786,8739,51,8688,4107,5712,186,1367,142,736,23,467,18,.084220164,.15642522,.65362167,.016248999,.0020597323,.0026318801,.053438608,.0212839,48017
48,018,BERRIATUA,945,601,160,441,0,441,344,336,2,21,5,19,2,51,1,.043083899,.047619049,.76190478,.011337869,.0022675737,.0045351475,.11564626,.0045351475,48018
48,021,BUSTURIA,1464,1069,177,892,8,884,395,543,35,85,25,122,0,65,4,.13677131,.09529148,.60874438,.028026905,.0044843052,0,.072869956,.039237667,48021
48,028,EA,780,619,149,470,6,464,161,316,6,89,7,17,1,24,1,.036170214,.18936171,.67234045,.014893617,.0021276595,.0021276595,.051063828,.012765957,48028
48,030,ETXEBARRIA,637,472,138,334,2,332,165,264,6,12,0,11,1,34,0,.032934133,.035928145,.79041916,0,0,.0029940121,.1017964,.017964073,48030
48,031,ELANTXOBE,389,301,61,240,0,240,88,184,2,25,0,5,0,23,1,.020833334,.10416666,.76666665,0,.0041666669,0,.095833331,.0083333338,48031
48,033,EREÑO,219,172,23,149,2,147,47,108,6,12,1,7,0,13,0,.046979867,.080536909,.72483224,.0067114094,0,0,.087248325,.040268455,48033
48,035,FRUIZ,346,277,55,222,1,221,69,176,4,7,5,15,1,10,2,.067567565,.031531531,.7927928,.022522522,.0090090092,.0045045046,.045045044,.018018018,48035
48,038,GAMIZ-FIKA,1064,816,98,718,0,718,248,509,24,56,8,52,2,60,6,.072423398,.077994429,.70891362,.011142061,.0083565461,.0027855153,.083565459,.033426184,48038
48,040,GATIKA,1246,934,100,834,8,826,312,560,27,82,16,68,2,63,5,.081534773,.098321341,.67146283,.019184653,.0059952037,.0023980816,.075539567,.032374099,48040
48,041,GAUTEGIZ ARTEAGA,723,594,100,494,6,488,129,351,13,24,6,43,2,45,3,.087044537,.048582997,.71052629,.012145749,.0060728746,.0040485831,.091093116,.02631579,48041
48,043,GORLIZ,4183,2996,249,2747,32,2715,1187,1555,186,120,96,437,16,236,40,.15908264,.043684021,.56607211,.034947217,.014561339,.0058245361,.085911907,.067710228,48043
48,044,GETXO,64533,46547,2372,44175,541,43634,17986,16361,10733,964,1035,10718,195,1713,1531,.24262592,.021822298,.37036785,.023429541,.034657612,.0044142613,.03877759,.24296547,48044
48,046,GERNIKA-LUMO,12617,9251,1269,7982,51,7931,3366,4333,413,1080,163,1158,20,680,38,.14507642,.13530444,.54284638,.020420948,.0047607115,.0025056377,.085191682,.051741417,48046
48,047,GIZABURUAGA,157,61,0,61,1,60,96,45,0,4,3,0,0,8,0,0,.065573767,.73770493,.049180329,0,0,.13114753,0,48047
48,048,IBARRANGELU,538,424,63,361,1,360,114,278,3,16,4,18,1,37,1,.049861494,.044321328,.77008313,.011080332,.002770083,.002770083,.10249308,.0083102491,48048
48,049,ISPASTER,578,436,68,368,3,365,142,273,6,24,3,10,1,47,0,.027173912,.065217391,.74184781,.0081521738,0,.0027173914,.12771739,.016304348,48049
48,052,LARRABETZU,1491,1155,331,824,7,817,336,576,23,18,26,52,2,112,6,.063106798,.021844661,.69902915,.031553399,.0072815535,.0024271845,.13592233,.02791262,48052
48,053,LAUKIZ,836,667,51,616,1,615,169,395,76,27,5,88,0,16,6,.14285715,.04383117,.64123374,.0081168832,.0097402595,0,.025974026,.12337662,48053
48,054,LEIOA,23548,16193,871,15322,170,15152,7355,5946,2004,350,628,4924,78,525,497,.32136798,.022842972,.38806945,.040986817,.032437019,.0050907191,.034264456,.13079232,48054
48,056,LEMOIZ,837,603,78,525,4,521,234,386,16,21,19,39,1,37,1,.074285716,.039999999,.73523808,.036190476,.0019047619,.0019047619,.070476189,.03047619,48056
48,057,LEKEITIO,6069,4354,1103,3251,14,3237,1715,2062,92,465,68,175,8,355,6,.053829592,.14303291,.63426638,.020916641,.001845586,.0024607813,.10919717,.028298985,48057
48,060,MARKINA-XEMEIN,3675,2417,458,1959,18,1941,1258,1379,54,73,37,107,1,283,5,.054619703,.037263911,.70393056,.018887186,.0025523226,.00051046454,.14446145,.027565084,48060
48,061,MARURI-JATABE,726,577,55,522,2,520,149,329,28,33,17,59,3,46,4,.11302682,.063218392,.63026822,.03256705,.0076628351,.0057471264,.088122606,.053639848,48061
48,062,MENDATA,313,252,35,217,1,216,61,161,3,36,2,5,0,8,0,.023041476,.16589862,.74193549,.0092165899,0,0,.036866359,.013824885,48062
48,063,MENDEXA,363,276,111,165,4,161,87,120,0,8,7,7,2,17,0,.042424243,.048484847,.72727275,.042424243,0,.012121212,.1030303,0,48063
48,064,MEÑAKA,572,464,51,413,0,413,108,228,9,93,8,22,0,50,0,.053268764,.22518159,.5520581,.019370461,0,0,.12106538,.021791767,48064
48,066,MORGA,360,272,30,242,0,242,88,204,4,10,2,3,2,15,1,.012396694,.041322313,.8429752,.0082644625,.0041322312,.0082644625,.06198347,.016528925,48066
48,067,MUXIKA,1216,913,179,734,6,728,303,513,13,75,8,34,0,80,1,.046321526,.10217984,.69891006,.010899182,.0013623978,0,.10899182,.017711172,48067
48,068,MUNDAKA,1579,1238,146,1092,13,1079,341,805,18,96,15,60,3,79,0,.054945055,.08791209,.73717946,.013736264,0,.0027472528,.072344325,.016483517,48068
48,069,MUNGIA,12137,8675,514,8161,64,8097,3462,4929,628,431,203,1257,28,484,93,.15402524,.052812155,.60397011,.024874402,.011395662,.0034309521,.059306458,.076951355,48069
48,070,AULESTI,571,405,174,231,5,226,166,192,2,5,0,1,1,24,0,.0043290043,.021645023,.83116883,0,0,.0043290043,.1038961,.0086580086,48070
48,073,ONDARROA,7231,4862,1580,3282,26,3256,2369,2190,204,200,39,233,4,366,4,.070993297,.060938451,.66727602,.011882998,.001218769,.001218769,.11151737,.062157221,48073
48,076,SUKARRIETA,298,251,39,212,1,211,47,138,11,21,2,18,0,17,0,.084905662,.099056602,.6509434,.0094339624,0,0,.080188677,.051886793,48076
48,077,PLENTZIA,3341,2461,195,2266,20,2246,880,1357,200,95,59,308,13,159,38,.13592233,.041924097,.59885257,.026037069,.016769638,.0057369815,.070167698,.088261254,48077
48,079,ERRIGOITI,441,361,55,306,0,306,80,239,6,30,4,6,1,17,2,.019607844,.098039217,.78104573,.013071896,.0065359478,.0032679739,.055555556,.019607844,48079
48,081,LEZAMA,1934,1405,155,1250,12,1238,529,822,67,47,35,175,4,68,12,.14,.037599999,.65759999,.028000001,.0096000005,.0031999999,.054400001,.053599998,48081
48,085,SOPELANA,9652,6485,668,5817,73,5744,3167,2890,415,194,286,1380,49,367,113,.2372357,.033350524,.49681967,.049166236,.019425821,.0084235864,.063090943,.071342617,48085
48,089,URDULIZ,2679,1897,207,1690,19,1671,782,945,95,97,54,320,21,103,20,.18934911,.057396449,.55917162,.031952664,.01183432,.012426035,.060946744,.056213018,48089
48,901,DERIO,4309,3046,136,2910,30,2880,1263,1294,254,101,82,981,23,75,27,.33711341,.034707904,.44467354,.028178694,.0092783505,.0079037799,.025773196,.087285221,48901
48,902,ERANDIO,19331,12390,768,11622,113,11509,6941,5309,1173,176,342,3926,62,319,106,.3378076,.015143693,.45680606,.029426949,.0091206329,.0053347102,.027447943,.10092928,48902
48,903,LOIU,1680,1308,70,1238,10,1228,372,826,141,26,19,143,3,41,18,.11550888,.021001615,.66720515,.015347335,.01453958,.0024232634,.033117931,.11389337,48903
48,904,SONDIKA,3609,2707,153,2554,28,2526,902,1497,245,81,41,523,10,96,20,.20477682,.031714957,.58613938,.01605325,.0078308536,.0039154268,.037588097,.095927954,48904
48,905,ZAMUDIO,2613,1889,213,1676,25,1651,724,1018,112,53,46,334,1,68,10,.199284,.031622913,.60739857,.0274463,.005966587,.00059665873,.040572792,.066825777,48905
48,906,FORUA,821,597,145,452,1,451,224,333,7,18,6,42,0,40,4,.092920355,.039823011,.73672569,.013274336,.0088495575,0,.088495575,.015486726,48906
48,907,KORTEZUBI,346,300,67,233,1,232,46,169,6,26,1,10,0,17,1,.042918455,.11158799,.72532189,.0042918455,.0042918455,0,.072961375,.025751073,48907
48,908,MURUETA,248,193,42,151,0,151,55,114,0,6,2,15,0,11,1,.099337749,.039735101,.75496691,.013245033,.0066225166,0,.072847679,0,48908
48,909,NABARNIZ,194,171,51,120,2,118,23,98,0,9,1,0,0,9,0,0,.075000003,.81666666,.0083333338,0,0,.075000003,0,48909
48,911,AJANGIZ,370,281,95,186,1,185,89,123,1,23,2,11,0,24,0,.059139784,.12365592,.66129035,.010752688,0,0,.12903225,.0053763441,48911
48,914,ARRATZU,319,255,64,191,1,190,64,158,1,8,1,3,0,19,0,.015706806,.041884817,.82722515,.0052356021,0,0,.099476442,.0052356021,48914
48,915,ZIORTZA - BOLIBAR,347,260,76,184,0,184,87,161,2,3,3,3,1,11,0,.016304348,.016304348,.875,.016304348,0,.0054347827,.059782609,.010869565,48915
48,999,MUNICIPIO CERA BIZKAIA,23371,3733,51,3682,35,3647,19638,1410,548,80,96,1182,38,53,78,.32102117,.021727322,.38294405,.026072787,.021184139,.010320478,.014394351,.14883216,48999
