prov,codmunicipio,ambito,censo_2005,votantes_2005,nulos_2005,vlidos_2005,blancos_2005,votoscand_2005,abstenciones_2005,pp_2005,ual_2005,eb_2005,pse_2005,eajpnv_2005,aralar_2005,berdeakpacma_2005,pctvehak_2005,share_pp_2005,share_pse_2005,share_eajpnv_2005,share_eb_2005,share_aralar_2005,share_ual_2005,share_berdeakpacma_2005,share_pctvehak_2005,id
01,059,VITORIA-GASTEIZ,183324,126491,471,126020,1008,125012,56833,35218,3180,6669,35896,32451,1744,698,8693,.27946359,.28484368,.25750676,.05292017,.013839073,.02523409,.0055388035,.068981111,01059
01,001,ALEGRÍA-DULANTZI,1583,1120,3,1117,6,1111,463,177,15,67,253,451,26,2,117,.15846016,.22649956,.40376008,.059982095,.023276635,.013428827,.0017905103,.10474485,01001
01,003,ARAMAIO,1239,980,5,975,1,974,259,16,2,62,26,561,58,0,249,.016410256,.026666667,.57538462,.063589744,.059487179,.002051282,0,.25538462,01003
01,006,ARMIÑÓN,144,107,0,107,0,107,37,44,7,3,23,22,0,0,8,.41121495,.21495327,.20560747,.028037382,0,.065420561,0,.074766353,01006
01,008,ARRAZUA-UBARRUNDIA,688,521,3,518,7,511,167,121,11,22,85,217,10,2,41,.23359074,.16409266,.41891891,.042471044,.019305019,.021235522,.0038610038,.07915058,01008
01,009,ASPARRENA,1334,880,7,873,3,870,454,81,10,53,83,386,46,1,208,.092783503,.095074452,.44215348,.060710195,.052691866,.011454754,.0011454754,.23825888,01009
01,011,BAÑOS DE EBRO / MAÑUETA,271,223,1,222,3,219,48,91,7,3,23,88,0,0,7,.4099099,.1036036,.3963964,.013513514,0,.031531531,0,.031531531,01011
01,013,BARRUNDIA,647,468,0,468,4,464,179,69,9,29,54,213,12,3,74,.1474359,.11538462,.45512819,.061965812,.025641026,.01923077,.0064102565,.15811966,01013
01,014,BERANTEVILLA,406,298,1,297,3,294,108,99,7,9,32,125,7,0,15,.33333334,.10774411,.42087543,.030303031,.023569023,.023569023,0,.05050505,01014
01,016,BERNEDO,499,311,1,310,2,308,188,100,5,14,31,115,6,0,36,.32258064,.1,.37096775,.045161292,.019354839,.016129032,0,.11612903,01016
01,017,CAMPEZO / KANPEZU,913,664,2,662,3,659,249,163,6,33,70,296,5,0,84,.24622357,.10574018,.44712991,.049848944,.0075528701,.0090634441,0,.12688822,01017
01,018,ZIGOITIA,1143,830,3,827,15,812,313,101,13,33,128,353,21,1,162,.12212817,.1547763,.426844,.039903264,.025392987,.015719468,.0012091899,.19588876,01018
01,019,KRIPAN,158,139,0,139,1,138,19,29,2,1,3,98,0,1,4,.2086331,.021582734,.70503598,.0071942448,0,.01438849,.0071942448,.028776979,01019
01,020,KUARTANGO,326,239,1,238,0,238,87,26,3,6,18,138,6,1,40,.1092437,.075630255,.57983196,.025210084,.025210084,.012605042,.0042016809,.16806723,01020
01,021,ELBURGO / BURGELU,371,266,1,265,1,264,105,70,3,12,39,115,2,1,20,.26415095,.14716981,.43396226,.04528302,.0075471699,.011320755,.003773585,.075471699,01021
01,022,ELCIEGO,816,619,9,610,4,606,197,211,15,24,175,158,2,1,20,.34590164,.28688523,.25901639,.039344262,.0032786885,.024590164,.0016393443,.032786883,01022
01,023,ELVILLAR / BILAR,306,228,1,227,1,226,78,91,2,7,18,93,2,0,12,.40088105,.079295151,.40969163,.030837005,.0088105723,.0088105723,0,.052863438,01023
01,027,IRURAIZ-GAUNA,405,285,4,281,1,280,120,58,7,9,23,125,2,3,53,.2064057,.081850536,.44483986,.03202847,.0071174377,.024911031,.010676157,.1886121,01027
01,028,LABASTIDA / BASTIDA,1097,790,0,790,8,782,307,269,14,45,147,234,8,3,61,.34050632,.18607596,.29620254,.056962024,.010126582,.017721519,.0037974683,.077215187,01028
01,030,LAGRÁN,179,137,0,137,1,136,42,54,8,2,19,44,6,2,1,.3941606,.13868614,.32116789,.01459854,.043795619,.05839416,.01459854,.00729927,01030
01,031,LAGUARDIA,1224,955,9,946,12,934,269,423,13,8,123,321,8,0,36,.44714588,.13002114,.33932346,.0084566595,.0084566595,.013742072,0,.038054969,01031
01,032,LANCIEGO / LANTZIEGO,543,406,7,399,4,395,137,109,12,9,86,159,2,2,14,.27318296,.21553884,.39849624,.022556391,.0050125313,.030075189,.0050125313,.03508772,01032
01,033,LAPUEBLA DE LABARCA,702,549,0,549,1,548,153,136,5,10,86,297,8,0,6,.24772313,.15664846,.54098362,.018214935,.014571949,.0091074677,0,.010928961,01033
01,034,LEZA,182,149,0,149,2,147,33,18,0,5,25,85,0,2,10,.12080537,.16778524,.5704698,.033557046,0,0,.013422819,.067114092,01034
01,037,ARRAIA-MAEZTU,631,449,8,441,1,440,182,108,10,16,61,192,9,3,40,.24489796,.138322,.43537414,.03628118,.020408163,.022675738,.0068027209,.090702951,01037
01,039,MOREDA DE ÁLAVA,236,186,0,186,0,186,50,52,1,8,58,64,0,1,2,.27956989,.31182796,.34408602,.043010753,0,.0053763441,.0053763441,.010752688,01039
01,041,NAVARIDAS,168,135,0,135,2,133,33,66,3,2,11,50,0,1,0,.48888889,.081481479,.37037036,.014814815,0,.022222223,.0074074073,0,01041
01,043,OYÓN-OION,2257,1476,5,1471,4,1467,781,507,22,51,360,372,11,9,134,.3446635,.24473147,.25288919,.034670293,.0074779061,.014955812,.0061182869,.091094494,01043
01,044,PEÑACERRADA-URIZAHARRA,230,168,3,165,0,165,62,49,5,10,22,61,3,1,13,.29696971,.13333334,.36969697,.060606062,.018181818,.030303031,.0060606059,.078787878,01044
01,046,RIBERA ALTA,515,374,1,373,1,372,141,127,4,6,42,147,7,1,35,.34048256,.11260054,.39410189,.01608579,.018766755,.010723861,.0026809652,.093833782,01046
01,047,RIBERA BAJA / ERRIBERA BEITIA,808,566,5,561,7,554,242,199,11,18,151,150,3,3,14,.35472372,.26916221,.26737967,.03208556,.0053475937,.019607844,.0053475937,.024955437,01047
01,049,AÑANA,170,142,1,141,0,141,28,37,1,0,25,64,1,0,13,.26241136,.17730497,.45390069,0,.0070921984,.0070921984,0,.092198581,01049
01,051,SALVATIERRA / AGURAIN,3359,2216,6,2210,5,2205,1143,289,38,97,347,960,46,6,417,.13076924,.15701358,.43438914,.043891404,.02081448,.017194571,.0027149322,.18868779,01051
01,052,SAMANIEGO,249,200,2,198,1,197,49,22,2,6,40,92,6,0,26,.11111111,.2020202,.46464646,.030303031,.030303031,.01010101,0,.13131313,01052
01,053,SAN MILLÁN / DONEMILIAGA,614,368,0,368,4,364,246,48,5,16,21,196,15,2,60,.13043478,.057065219,.53260869,.043478262,.040760871,.013586956,.0054347827,.16304348,01053
01,054,URKABUSTAIZ,788,566,3,563,3,560,222,72,5,16,64,244,12,0,146,.12788633,.11367673,.43339255,.028419184,.021314388,.0088809943,0,.25932506,01054
01,055,VALDEGOVÍA / GAUBEA,954,671,5,666,7,659,283,200,20,27,81,251,9,6,60,.3003003,.12162162,.37687689,.040540539,.013513514,.030030031,.0090090092,.090090089,01055
01,056,HARANA / VALLE DE ARANA,296,198,1,197,2,195,98,55,5,2,10,98,5,0,18,.27918783,.05076142,.49746192,.010152284,.02538071,.02538071,0,.09137056,01056
01,057,VILLABUENA DE ÁLAVA / ESKUERNAGA,273,234,0,234,0,234,39,50,0,3,12,134,0,1,34,.21367522,.051282052,.5726496,.012820513,0,0,.0042735045,.14529915,01057
01,058,LEGUTIANO,1250,872,2,870,4,866,378,57,12,49,120,410,25,4,189,.065517239,.13793103,.47126436,.056321841,.028735632,.013793103,.0045977011,.21724138,01058
01,060,YÉCORA / IEKORA,231,195,1,194,5,189,36,91,6,2,29,59,0,1,1,.46907216,.14948453,.3041237,.010309278,0,.030927835,.005154639,.005154639,01060
01,061,ZALDUONDO,143,111,0,111,1,110,32,8,0,13,16,51,4,0,18,.072072074,.14414415,.45945945,.11711711,.036036037,0,0,.16216215,01061
01,062,ZAMBRANA,320,223,1,222,0,222,97,78,6,5,30,92,4,0,6,.35135135,.13513513,.41441441,.022522522,.018018018,.027027028,0,.027027028,01062
01,063,ZUIA,1708,1289,4,1285,8,1277,419,225,14,42,173,608,28,9,176,.17509727,.13463035,.47315174,.032684825,.021789884,.010894942,.0070038913,.13696498,01063
01,901,IRUÑA OKA / IRUÑA DE OCA,1771,1202,7,1195,5,1190,569,357,23,37,366,313,10,8,70,.29874477,.30627614,.26192468,.030962342,.0083682006,.019246861,.0066945609,.058577407,01901
01,902,LANTARÓN,849,547,1,546,3,543,302,194,14,24,85,179,9,1,37,.35531136,.15567766,.32783884,.043956045,.016483517,.025641026,.0018315018,.067765571,01902
01,002,AMURRIO,8014,6027,27,6000,38,5962,1987,787,54,232,961,3098,107,23,687,.13116667,.16016667,.51633334,.038666666,.017833333,.0089999996,.0038333333,.1145,01002
01,004,ARTZINIEGA,1220,944,9,935,10,925,276,186,5,33,104,442,53,4,96,.19893049,.11122995,.47272727,.035294119,.05668449,.0053475937,.0042780749,.1026738,01004
01,010,AYALA / AIARA,2130,1654,8,1646,14,1632,476,237,15,59,144,975,31,1,168,.14398542,.087484814,.59234506,.035844471,.018833537,.0091130016,.00060753344,.10206562,01010
01,036,LAUDIO / LLODIO,15967,11324,55,11269,67,11202,4643,1835,100,460,2179,4811,145,34,1614,.1628361,.19336233,.42692342,.040819947,.012867157,.0088739023,.0030171266,.14322478,01036
01,042,OKONDO,833,676,4,672,1,671,157,58,2,21,19,442,11,2,116,.086309522,.02827381,.65773809,.03125,.016369049,.0029761905,.0029761905,.17261904,01042
01,999,MUNICIPIO CERA ARABA,3161,824,1,823,0,823,2337,221,26,19,219,286,7,7,26,.26852977,.26609963,.34750912,.02308627,.0085054683,.031591736,.0085054683,.031591736,01999
01,040,HERNANI,15412,10077,17,10060,71,9989,5335,822,1,538,1691,2876,467,26,3544,.081709743,.16809145,.28588468,.053479124,.046421472,.00009940358,.002584493,.35228628,01040
01,069,DONOSTIA-SAN SEBASTIÁN,150090,102324,263,102061,1019,101042,47766,22156,29,5820,23805,32753,3200,318,12682,.21708585,.23324287,.32091594,.057024721,.031353798,.00028414381,.0031157837,.12425902,01069
01,072,URNIETA,4543,2951,14,2937,18,2919,1592,340,1,168,778,1025,115,6,479,.11576439,.26489615,.34899557,.057201225,.039155602,.0003404835,.002042901,.16309159,01072
01,073,USURBIL,4663,3287,7,3280,20,3260,1376,180,1,113,378,1282,206,5,1087,.054878049,.1152439,.39085367,.03445122,.062804878,.00030487805,.0015243902,.33140245,01073
01,902,LASARTE-ORIA,14843,9948,20,9928,81,9847,4895,1475,10,502,3655,2577,244,46,1297,.1485697,.36815068,.2595689,.050564062,.024576955,.0010072523,.0046333601,.13064061,01902
01,903,ASTIGARRAGA,3263,2172,7,2165,17,2148,1091,194,0,93,198,915,97,4,643,.089607388,.091454968,.42263278,.042956121,.044803694,0,.0018475751,.2969977,01903
01,036,HONDARRIBIA,12757,8887,85,8802,87,8715,3870,1012,1,446,1217,4470,422,22,1110,.11497387,.13826403,.50783914,.050670303,.047943648,.00011361054,.0024994318,.12610771,01036
01,045,IRUN,48252,31065,202,30863,298,30565,17187,6065,12,1663,10279,9241,639,151,2385,.19651362,.33305252,.29942003,.053883292,.020704404,.0003888151,.00489259,.077276997,01045
01,053,LEZO,4847,3093,3,3090,15,3075,1754,187,0,150,525,980,126,6,1096,.060517799,.16990291,.31715211,.048543688,.0407767,0,.0019417476,.35469255,01053
01,063,OIARTZUN,7817,5582,8,5574,26,5548,2235,277,1,249,325,2238,247,5,2203,.049695011,.058306422,.40150699,.044671688,.044312879,.00017940438,.00089702191,.39522785,01063
01,064,PASAIA,13194,7955,23,7932,65,7867,5239,980,6,448,1679,2552,211,36,1924,.12355018,.21167423,.32173476,.05648008,.02660111,.00075642962,.004538578,.24256177,01064
01,067,ERRENTERIA,32161,20053,59,19994,125,19869,12108,2542,8,1249,6225,5344,557,113,3726,.12713814,.3113434,.26728019,.062468741,.027858358,.00040012004,.0056516957,.1863559,01067
20,001,ABALTZISKETA,232,165,1,164,0,164,67,2,0,7,1,95,5,0,54,.012195121,.0060975607,.57926828,.042682927,.030487806,0,0,.32926831,20001
20,002,ADUNA,296,232,0,232,1,231,64,0,0,5,3,89,21,0,113,0,.012931035,.38362068,.021551725,.090517238,0,0,.48706895,20002
20,004,ALBIZTUR,249,175,1,174,1,173,74,2,0,2,3,129,9,0,28,.011494253,.017241379,.74137932,.011494253,.05172414,0,0,.16091955,20004
20,005,ALEGIA,1360,955,2,953,3,950,405,46,0,25,59,473,54,1,290,.048268624,.061909758,.4963274,.026232949,.05666317,0,.0010493179,.30430222,20005
20,006,ALKIZA,235,176,0,176,0,176,59,1,0,8,2,117,5,0,41,.0056818184,.011363637,.66477275,.045454547,.028409092,0,0,.23295455,20006
20,007,ALTZO,285,216,0,216,0,216,69,4,1,3,1,91,17,2,96,.018518519,.0046296297,.4212963,.013888889,.078703701,.0046296297,.0092592593,.44444445,20007
20,008,AMEZKETA,820,574,0,574,5,569,246,21,1,20,5,276,34,2,209,.036585364,.0087108016,.48083624,.034843206,.059233449,.0017421603,.0034843206,.36411151,20008
20,009,ANDOAIN,11863,7890,21,7869,34,7835,3973,933,4,457,2180,2568,191,36,1441,.11856653,.27703646,.32634389,.058075994,.024272462,.00050832378,.004574914,.18312365,20009
20,010,ANOETA,1426,1006,4,1002,10,992,420,66,0,40,92,397,45,4,347,.065868266,.091816366,.39620757,.039920159,.044910181,0,.003992016,.3463074,20010
20,012,ARAMA,136,107,0,107,0,107,29,4,0,2,3,45,3,0,50,.037383176,.028037382,.42056075,.018691588,.028037382,0,0,.46728972,20012
20,014,ASTEASU,1105,737,1,736,2,734,368,21,0,33,23,369,36,2,250,.028532609,.03125,.50135869,.044836957,.048913043,0,.0027173914,.33967391,20014
20,015,ATAUN,1339,1111,2,1109,1,1108,228,7,0,19,21,498,63,0,500,.0063119926,.018935978,.4490532,.017132552,.056807935,0,0,.45085663,20015
20,019,BEASAIN,10167,6976,18,6958,37,6921,3191,679,1,373,1395,3059,285,23,1079,.097585514,.20048864,.43963784,.05360736,.040960047,.00014371946,.0033055476,.1550733,20019
20,021,BELAUNTZA,255,178,2,176,2,174,77,7,0,2,3,68,25,0,69,.039772727,.017045455,.38636363,.011363637,.14204545,0,0,.39204547,20021
20,022,BERASTEGI,793,561,1,560,1,559,232,6,1,9,12,357,25,0,149,.010714286,.021428572,.63749999,.016071429,.044642858,.0017857143,0,.26607144,20022
20,023,BERROBI,449,313,1,312,0,312,136,21,0,5,13,162,10,0,101,.067307696,.041666668,.51923078,.016025642,.032051284,0,0,.32371795,20023
20,025,ZEGAMA,1088,873,0,873,2,871,215,12,0,10,10,550,36,0,253,.013745705,.011454754,.63001144,.011454754,.041237112,0,0,.28980526,20025
20,026,ZERAIN,213,181,1,180,0,180,32,0,0,2,1,100,9,0,68,0,.0055555557,.55555558,.011111111,.050000001,0,0,.37777779,20026
20,028,ZIZURKIL,2267,1464,6,1458,11,1447,803,122,1,64,207,569,57,5,420,.083676271,.14197531,.39026064,.043895748,.039094649,.00068587105,.0034293553,.28806585,20028
20,031,ELDUAIN,175,128,0,128,0,128,47,2,0,0,1,63,1,0,61,.015625,.0078125,.4921875,0,.0078125,0,0,.4765625,20031
20,035,EZKIO-ITSASO,456,345,0,345,1,344,111,3,0,12,1,165,29,0,134,.0086956518,.0028985508,.47826087,.034782607,.084057972,0,0,.3884058,20035
20,037,GAINTZA,103,81,2,79,1,78,22,0,1,1,0,47,3,0,26,0,0,.59493673,.012658228,.037974682,.012658228,0,.32911393,20037
20,038,GABIRIA,331,266,1,265,0,265,65,4,0,2,3,182,12,0,61,.01509434,.011320755,.68679243,.0075471699,.04528302,0,0,.23018868,20038
20,041,HERNIALDE,262,176,0,176,0,176,86,5,0,8,6,79,17,0,60,.028409092,.03409091,.44886363,.045454547,.096590906,0,0,.34090909,20041
20,042,IBARRA,3608,2416,5,2411,19,2392,1192,174,0,118,370,914,106,5,704,.072169222,.15346329,.37909582,.048942346,.043965161,0,.0020738284,.29199502,20042
20,043,IDIAZABAL,1775,1372,1,1371,10,1361,403,49,0,25,48,853,67,0,319,.035740335,.035010941,.62217361,.018234866,.048869438,0,0,.23267688,20043
20,044,IKAZTEGIETA,317,239,0,239,0,239,78,6,0,11,9,108,12,1,92,.025104603,.037656903,.45188284,.046025105,.050209206,0,.0041841003,.38493723,20044
20,046,IRURA,873,624,1,623,4,619,249,36,0,17,48,290,38,3,186,.057784911,.077046551,.46548957,.027287319,.060995184,0,.0048154094,.29855537,20046
20,047,ITSASONDO,473,331,0,331,2,329,142,6,0,5,7,157,21,0,133,.018126888,.021148037,.47432023,.01510574,.063444108,0,0,.4018127,20047
20,048,LARRAUL,131,88,0,88,1,87,43,1,0,4,1,44,2,0,35,.011363637,.011363637,.5,.045454547,.022727273,0,0,.39772728,20048
20,049,LAZKAO,4142,2903,3,2900,22,2878,1239,229,0,105,500,1161,120,8,744,.078965515,.1724138,.40034482,.036206897,.04137931,0,.0027586208,.25655171,20049
20,050,LEABURU,311,256,1,255,1,254,55,7,0,4,4,89,16,1,132,.027450981,.015686275,.34901962,.015686275,.062745102,0,.0039215689,.51764709,20050
20,051,LEGAZPI,7362,5307,14,5293,28,5265,2055,532,1,296,890,2402,282,15,833,.10051011,.16814661,.45380691,.055922918,.053277913,.00018892877,.0028339317,.15737768,20051
20,052,LEGORRETA,1148,828,5,823,2,821,320,50,0,34,92,398,34,1,210,.060753342,.11178615,.48359659,.041312274,.041312274,0,.0012150669,.25516403,20052
20,054,LIZARTZA,517,390,2,388,3,385,127,8,0,3,4,125,14,0,230,.020618556,.010309278,.32216495,.0077319588,.036082473,0,0,.59278351,20054
20,057,MUTILOA,140,97,1,96,1,95,43,0,0,1,0,60,4,0,30,0,0,.625,.010416667,.041666668,0,0,.3125,20057
20,058,OLABERRIA,780,555,2,553,5,548,225,63,0,25,115,223,14,5,100,.11392405,.2079566,.40325499,.045207955,.025316456,0,.0090415915,.18083182,20058
20,060,OREXA,73,72,0,72,1,71,1,0,0,0,0,6,1,0,64,0,0,.083333336,0,.013888889,0,0,.8888889,20060
20,062,ORMAIZTEGI,1004,805,1,804,1,803,199,30,0,27,35,481,43,2,184,.037313432,.043532338,.59825873,.033582091,.053482588,0,.0024875621,.22885571,20062
20,070,SEGURA,1003,790,5,785,5,780,213,23,0,6,12,480,26,2,230,.029299363,.015286624,.61146498,.0076433122,.03312102,0,.0025477707,.29299363,20070
20,071,TOLOSA,14678,10060,20,10040,74,9966,4618,906,3,580,1169,4447,502,25,2309,.090239041,.11643426,.44292828,.057768926,.050000001,.00029880478,.0024900399,.22998008,20071
20,075,VILLABONA,4634,3190,0,3190,16,3174,1444,267,2,150,402,1300,141,12,893,.083699062,.12601881,.40752351,.047021944,.044200625,.00062695926,.0037617555,.2799373,20075
20,076,ORDIZIA,7196,5050,11,5039,21,5018,2146,530,0,294,936,1934,239,12,1059,.1051796,.18575114,.38380632,.058344908,.047430046,0,.0023814249,.21016075,20076
20,077,URRETXU,5544,4091,7,4084,31,4053,1453,377,2,218,849,1750,158,11,685,.092311457,.20788443,.42850146,.05337904,.038687561,.00048971595,.0026934377,.16772772,20077
20,078,ZALDIBIA,1210,922,0,922,3,919,288,23,0,16,40,269,110,0,460,.024945769,.043383949,.29175705,.017353579,.11930586,0,0,.4989154,20078
20,080,ZUMARRAGA,8435,5898,23,5875,56,5819,2537,722,4,354,1765,2046,136,25,748,.12289362,.30042553,.34825531,.060255319,.023148935,.00068085105,.004255319,.12731914,20080
20,904,BALIARRAIN,85,59,0,59,0,59,26,0,0,2,1,16,3,0,37,0,.016949153,.27118644,.033898305,.050847456,0,0,.62711865,20904
20,905,ORENDAIN,141,109,1,108,0,108,32,0,0,1,0,58,6,0,43,0,0,.53703701,.0092592593,.055555556,0,0,.39814815,20905
20,906,ALTZAGA,126,105,0,105,2,103,21,0,0,2,4,41,9,3,44,0,.03809524,.3904762,.01904762,.085714288,0,.028571429,.41904762,20906
20,907,GAZTELU,127,98,0,98,0,98,29,0,0,9,1,41,1,0,46,0,.010204081,.41836736,.091836736,.010204081,0,0,.46938777,20907
20,003,AIZARNAZABAL,484,336,0,336,3,333,148,0,0,9,7,151,21,1,143,0,.020833334,.44940478,.026785715,.0625,0,.0029761905,.42559522,20003
20,011,ANTZUOLA,1710,1324,2,1322,8,1314,386,52,0,47,162,546,75,2,430,.039334342,.12254161,.4130106,.035552192,.056732222,0,.0015128592,.32526475,20011
20,013,ARETXABALETA,5262,3810,27,3783,13,3770,1452,266,3,193,534,1553,288,13,909,.070314564,.14115781,.41052076,.051017709,.076130055,.00079302141,.0034364262,.24028549,20013
20,016,AIA,1389,976,0,976,3,973,413,14,0,19,13,694,35,1,196,.014344262,.013319672,.71106559,.019467212,.035860654,0,.0010245901,.20081967,20016
20,017,AZKOITIA,8592,6256,22,6234,30,6204,2336,450,6,199,691,3420,257,16,1142,.072184794,.11084376,.54860443,.031921718,.041225538,.00096246391,.0025665704,.18318896,20017
20,018,AZPEITIA,11248,8411,11,8400,44,8356,2837,394,2,199,429,4907,332,23,2059,.046904761,.051071428,.58416665,.023690477,.03952381,.00023809524,.0027380954,.24511905,20018
20,020,BEIZAMA,145,107,0,107,0,107,38,1,0,1,0,59,2,0,44,.0093457941,0,.55140185,.0093457941,.018691588,0,0,.41121495,20020
20,024,BIDEGOIAN,360,263,0,263,1,262,97,8,0,2,1,163,5,0,83,.030418251,.0038022813,.61977184,.0076045627,.019011406,0,0,.31558937,20024
20,027,ZESTOA,2696,2041,3,2038,11,2027,655,45,0,57,92,1063,105,4,660,.022080472,.045142297,.52158982,.027968597,.0515211,0,.0019627085,.32384691,20027
20,029,DEBA,4344,3246,1,3245,14,3231,1098,192,2,173,294,1760,147,12,646,.059167951,.090600923,.54237288,.05331279,.045300461,.00061633281,.003697997,.19907551,20029
20,030,EIBAR,23740,16464,25,16439,119,16320,7276,2125,4,899,4410,6334,494,48,1952,.12926577,.2682645,.38530323,.054687023,.03005049,.0002433238,.0029198856,.11874202,20030
20,032,ELGOIBAR,8965,6500,23,6477,36,6441,2465,717,0,356,1132,2873,281,13,1047,.1106994,.17477228,.44356954,.054963719,.043384284,0,.0020071021,.16164891,20032
20,033,ELGETA,860,659,0,659,8,651,201,25,0,27,22,301,106,0,170,.037936267,.033383913,.45675266,.040971167,.16084976,0,0,.25796661,20033
20,034,ESKORIATZA,3277,2176,4,2172,10,2162,1101,142,1,136,365,928,96,11,470,.065377533,.16804788,.42725599,.062615104,.044198897,.00046040516,.0050644567,.21639043,20034
20,039,GETARIA,1979,1630,10,1620,4,1616,349,27,0,43,40,943,152,1,410,.016666668,.024691358,.58209878,.026543209,.093827158,0,.00061728398,.25308642,20039
20,055,ARRASATE / MONDRAGON,19313,13114,38,13076,48,13028,6199,1194,13,1006,2599,4657,621,44,2860,.091312326,.19876109,.35614866,.076934844,.047491588,.00099418778,.0033649434,.21872132,20055
20,056,MUTRIKU,3935,2969,20,2949,16,2933,966,151,0,68,124,1559,112,58,858,.051203799,.042048153,.5286538,.023058664,.037978977,0,.019667683,.2909461,20056
20,059,OÑATI,8853,6587,13,6574,30,6544,2266,372,0,298,465,3367,517,12,1501,.056586552,.07073319,.51216912,.045330089,.078643143,0,.0018253727,.2283237,20059
20,061,ORIO,3754,2731,8,2723,19,2704,1023,102,0,129,250,1508,166,4,541,.037458684,.091810502,.55380094,.047374219,.060962174,0,.001468968,.19867793,20061
20,065,SORALUZE-PLACENCIA DE LAS ARMAS,3475,2390,8,2382,8,2374,1085,309,1,93,434,928,90,5,509,.12972292,.18219984,.38958859,.039042823,.037783377,.00041981527,.0020990765,.21368597,20065
20,066,ERREZIL,501,361,1,360,1,359,140,3,0,2,0,188,6,0,160,.0083333338,0,.52222222,.0055555557,.016666668,0,0,.44444445,20066
20,068,LEINTZ-GATZAGA,214,176,0,176,0,176,38,4,0,4,1,88,10,1,67,.022727273,.0056818184,.5,.022727273,.056818184,0,.0056818184,.38068181,20068
20,074,BERGARA,12425,8735,23,8712,31,8681,3690,512,3,509,982,3871,782,9,2003,.058769513,.11271809,.44432965,.058425162,.08976125,.00034435262,.0010330578,.22991276,20074
20,079,ZARAUTZ,17253,12676,37,12639,82,12557,4577,1282,4,675,1775,6068,665,33,2020,.10143208,.14043833,.48010129,.053406123,.052614924,.00031648073,.0026109661,.15982278,20079
20,081,ZUMAIA,7043,4913,15,4898,24,4874,2130,347,1,220,809,2318,269,18,882,.070845246,.16516946,.47325438,.044916291,.054920375,.00020416497,.0036749693,.1800735,20081
20,901,MENDARO,1380,993,4,989,7,982,387,66,0,33,124,542,46,3,164,.066734076,.12537917,.54802829,.033367038,.046511628,0,.003033367,.16582407,20901
20,999,MUNICIPIO CERA GIPUZKOA,14121,3997,12,3985,19,3966,10124,743,4,136,1014,1601,88,57,282,.18644919,.2544542,.40175658,.03412798,.022082811,.0010037641,.014303639,.070765369,20999
48,020,BILBAO,293291,198745,570,198175,1650,196525,94546,46575,66,11664,48742,70667,2599,649,14450,.23501955,.24595433,.35658887,.058857072,.013114671,.00033303897,.0032748834,.072915353,48020
48,002,ABANTO Y CIÉRVANA-ABANTO ZIERBENA,7916,5097,19,5078,54,5024,2819,395,2,434,1428,2153,65,7,512,.077786528,.28121307,.42398581,.08546672,.012800315,.00039385585,.0013784955,.1008271,48002
48,008,ARTZENTALES,586,478,3,475,3,472,108,25,0,14,24,356,10,1,42,.052631579,.050526317,.74947369,.029473685,.021052632,0,.0021052631,.088421054,48008
48,013,BARAKALDO,82507,51556,200,51356,396,50960,30951,10513,31,3329,18249,14338,442,180,3518,.20470831,.3553431,.27918842,.064822026,.0086065894,.00060362957,.0035049459,.068502218,48013
48,022,KARRANTZA HARANA / VALLE DE CARRANZA,2472,1650,10,1640,3,1637,822,135,0,64,151,1102,27,3,152,.082317077,.092073172,.67195123,.03902439,.016463414,0,.0018292683,.092682928,48022
48,037,GALDAMES,736,584,2,582,3,579,152,24,0,38,40,365,19,0,92,.041237112,.068728521,.62714779,.065292098,.032646049,0,0,.1580756,48037
48,042,GORDEXOLA,1341,1141,9,1132,6,1126,200,177,0,52,108,705,16,2,61,.15636042,.095406361,.62279153,.045936394,.014134276,0,.0017667845,.053886924,48042
48,045,GÜEÑES,5071,4011,35,3976,34,3942,1060,297,1,140,569,2492,46,10,371,.074698187,.14310865,.62676054,.035211269,.011569416,.00025150905,.0025150906,.093309857,48045
48,051,LANESTOSA,245,193,0,193,1,192,52,28,0,10,26,113,3,3,7,.14507772,.13471502,.58549225,.051813472,.015544041,0,.015544041,.03626943,48051
48,071,MUSKIZ,5693,4186,22,4164,36,4128,1507,274,0,253,779,2320,43,10,434,.065802112,.18707973,.55715656,.060758885,.010326609,0,.002401537,.10422671,48071
48,078,PORTUGALETE,43226,28768,86,28682,207,28475,14458,5101,6,1947,10106,9015,254,92,1802,.17784673,.35234642,.31430861,.067882292,.0088557284,.00020919043,.0032075867,.062826857,48078
48,080,VALLE DE TRÁPAGA-TRAPAGARAN,10800,7219,31,7188,52,7136,3581,702,0,501,2421,2715,72,23,648,.097662769,.33681136,.37771285,.069699496,.010016695,0,.0031997773,.090150252,48080
48,082,SANTURTZI,40335,25923,75,25848,205,25643,14412,3895,10,1695,8522,8764,177,63,2352,.15068865,.32969669,.33905911,.065575674,.0068477252,.00038687713,.0024373259,.090993501,48082
48,083,ORTUELLA,7281,4791,15,4776,39,4737,2490,381,3,336,1527,2060,48,19,330,.079773866,.31972361,.43132329,.070351757,.010050251,.0006281407,.0039782245,.069095477,48083
48,084,SESTAO,26238,15872,57,15815,125,15690,10366,2518,7,1168,5607,4877,137,54,1222,.15921593,.35453683,.30837813,.07385394,.0086626625,.00044261778,.00341448,.077268414,48084
48,086,SOPUERTA,1968,1410,8,1402,3,1399,558,133,0,71,188,843,28,5,126,.09486448,.13409415,.60128391,.050641939,.019971469,0,.0035663338,.089871615,48086
48,087,TRUCIOS-TURTZIOZ,463,343,1,342,1,341,120,39,0,6,28,215,30,0,21,.11403508,.081871346,.62865496,.01754386,.087719299,0,0,.061403509,48087
48,090,BALMASEDA,6064,4522,39,4483,39,4444,1542,469,6,180,1016,2357,35,8,341,.10461745,.22663395,.52576399,.040151685,.007807272,.0013383895,.0017845193,.076065138,48090
48,096,ZALLA,6642,5195,49,5146,38,5108,1447,368,2,239,801,3247,79,14,336,.071511857,.15565488,.63097554,.046443839,.015351729,.00038865139,.0027205597,.065293431,48096
48,912,ALONSOTEGI,2375,1810,16,1794,8,1786,565,154,1,87,299,973,32,4,230,.085841693,.16666667,.54236341,.048494983,.017837236,.00055741362,.0022296545,.12820514,48912
48,913,ZIERBENA,1110,843,8,835,10,825,267,50,0,29,97,508,11,2,121,.059880238,.11616766,.60838324,.034730539,.013173653,0,.0023952096,.14491019,48913
48,001,ABADIÑO,5935,4036,10,4026,18,4008,1899,557,4,205,780,1512,159,10,755,.13835073,.19374068,.37555885,.050919026,.039493293,.00099354202,.002483855,.18753105,48001
48,003,AMOREBIETA-ETXANO,13938,10132,36,10096,48,10048,3806,838,5,682,1715,4803,251,22,1674,.083003171,.16986926,.47573295,.067551509,.024861332,.00049524562,.0021790809,.16580825,48003
48,005,ARAKALDO,80,64,0,64,0,64,16,7,0,1,1,34,2,0,19,.109375,.015625,.53125,.015625,.03125,0,0,.296875,48005
48,006,ARANTZAZU,248,217,0,217,3,214,31,7,0,7,6,133,5,0,56,.032258064,.02764977,.61290324,.032258064,.023041476,0,0,.25806451,48006
48,009,ARRANKUDIAGA,697,560,1,559,4,555,137,26,1,9,8,358,6,2,144,.046511628,.01431127,.64042932,.016100179,.010733453,.0017889087,.0035778175,.25760287,48009
48,011,ARRIGORRIAGA,9808,6555,17,6538,61,6477,3253,780,0,407,1566,2774,120,22,763,.11930254,.23952278,.42428878,.062251452,.018354237,0,.0033649434,.11670236,48011
48,015,BASAURI,38134,25050,89,24961,180,24781,13084,4143,12,1272,7917,8994,267,66,1928,.16597892,.31717479,.36032209,.050959498,.010696687,.00048074996,.0026441249,.077240497,48015
48,019,BERRIZ,3811,2684,11,2673,15,2658,1127,295,1,134,480,1158,116,4,449,.11036289,.17957351,.4332211,.050130937,.043396931,.00037411149,.001496446,.16797605,48019
48,023,ARTEA,560,485,3,482,0,482,75,33,0,6,7,299,26,0,109,.068464734,.014522822,.62033194,.012448133,.053941909,0,0,.22614108,48023
48,024,ZEANURI,1020,862,0,862,7,855,158,29,0,11,19,602,36,0,156,.033642691,.022041764,.69837588,.012761021,.041763343,0,0,.18097448,48024
48,025,ZEBERIO,873,685,1,684,4,680,188,18,0,17,25,435,12,0,170,.02631579,.036549706,.63596493,.024853801,.01754386,0,0,.24853802,48025
48,026,DIMA,962,821,1,820,5,815,141,25,0,13,3,470,29,0,273,.030487806,.0036585366,.57317072,.015853658,.035365853,0,0,.33292684,48026
48,027,DURANGO,21415,15240,32,15208,94,15114,6175,2192,4,868,2646,6561,599,24,2156,.14413467,.17398737,.43141767,.057075225,.039387167,.00026301946,.0015781168,.14176749,48027
48,029,ETXEBARRI,6413,4052,17,4035,33,4002,2361,722,2,290,1413,1273,31,22,211,.17893432,.35018587,.31548947,.071871124,.0076827756,.00049566297,.0054522925,.05229244,48029
48,032,ELORRIO,6014,4355,12,4343,17,4326,1659,458,0,221,649,1792,257,2,933,.10545706,.14943588,.41261801,.050886486,.059175685,0,.00046051116,.21482846,48032
48,034,ERMUA,13749,9014,25,8989,41,8948,4735,2515,9,521,3367,1709,122,46,550,.27978641,.37456891,.19012126,.057959728,.013572143,.0010012237,.0051173656,.061185893,48034
48,036,GALDAKAO,24600,16762,58,16704,106,16598,7838,2176,5,1061,3614,7314,304,43,1980,.1302682,.21635537,.43785921,.06351772,.018199233,.00029932949,.0025742338,.11853448,48036
48,039,GARAI,243,214,2,212,0,212,29,4,0,4,6,148,5,2,41,.018867925,.028301887,.6981132,.018867925,.023584906,0,.0094339624,.19339623,48039
48,050,IZURTZA,230,197,3,194,0,194,33,5,0,4,11,107,2,0,65,.025773196,.056701031,.55154639,.020618556,.010309278,0,0,.33505154,48050
48,055,LEMOA,2344,1884,14,1870,9,1861,460,145,1,74,141,1147,30,3,306,.077540107,.075401068,.61336899,.039572194,.01604278,.00053475937,.0016042781,.16363636,48055
48,058,MALLABIA,971,718,1,717,1,716,253,44,0,27,72,339,13,2,218,.061366808,.10041841,.47280335,.037656903,.018131102,0,.0027894003,.30404463,48058
48,059,MAÑARIA,390,309,0,309,3,306,81,10,0,10,9,181,10,0,85,.032362461,.029126214,.58576053,.032362461,.032362461,0,0,.27508092,48059
48,065,UGAO-MIRABALLES,3403,2377,12,2365,17,2348,1026,238,0,114,392,1139,26,5,427,.10063425,.16575053,.48160675,.048202962,.010993658,0,.0021141649,.18054968,48065
48,072,OTXANDIO,918,748,0,748,2,746,170,52,0,14,37,393,40,0,208,.069518715,.049465239,.52540106,.018716577,.053475935,0,0,.27807486,48072
48,074,URDUÑA-ORDUÑA,3357,2473,17,2456,10,2446,884,302,1,100,300,1261,52,3,410,.12296417,.12214984,.5134365,.040716611,.021172639,.00040716611,.0012214984,.16693811,48074
48,075,OROZKO,1876,1427,6,1421,9,1412,449,128,2,33,48,983,39,1,177,.090077408,.033779029,.69176638,.023223082,.027445462,.0014074595,.00070372975,.12456017,48075
48,088,UBIDE,132,109,0,109,0,109,23,8,0,1,1,53,6,0,40,.073394492,.0091743115,.48623854,.0091743115,.055045873,0,0,.36697248,48088
48,091,ATXONDO,1183,856,9,847,7,840,327,54,0,23,106,410,28,1,215,.063754424,.12514758,.48406139,.027154664,.03305785,0,.0011806375,.25383708,48091
48,092,BEDIA,808,615,4,611,3,608,193,45,0,17,51,409,3,0,83,.073649757,.083469719,.66939443,.027823241,.0049099838,0,0,.13584287,48092
48,093,AREATZA,826,670,5,665,6,659,156,83,0,21,27,362,35,2,124,.12481203,.040601503,.54436088,.031578947,.052631579,0,.0030075188,.18646617,48093
48,094,IGORRE,3303,2559,12,2547,18,2529,744,98,0,55,162,1525,109,8,563,.038476638,.063604243,.59874362,.021594033,.042795446,0,.0031409501,.22104436,48094
48,095,ZALDIBAR,2358,1601,5,1596,13,1583,757,223,1,55,369,602,40,1,286,.13972431,.231203,.37719297,.034461152,.025062656,.00062656641,.00062656641,.179198,48095
48,097,ZARATAMO,1351,952,2,950,9,941,399,79,0,25,166,470,17,2,177,.083157897,.17473684,.49473685,.02631579,.017894737,0,.0021052631,.18631579,48097
48,910,IURRETA,3420,2344,13,2331,11,2320,1076,334,2,98,516,872,63,0,414,.14328614,.22136422,.37408838,.042042043,.027027028,.00085800089,0,.17760618,48910
48,004,AMOROTO,308,250,0,250,3,247,58,0,0,2,0,175,7,0,63,0,0,.69999999,.0080000004,.028000001,0,0,.252,48004
48,007,MUNITIBAR-ARBATZEGI GERRIKAITZ-,315,262,1,261,2,259,53,3,0,3,0,166,5,1,81,.011494253,0,.6360153,.011494253,.019157087,0,.0038314175,.31034482,48007
48,010,ARRIETA,449,328,0,328,1,327,121,7,0,8,5,255,11,1,40,.021341464,.015243903,.777439,.024390243,.033536587,0,.0030487804,.12195122,48010
48,012,BAKIO,1731,1413,8,1405,3,1402,318,58,0,71,59,953,41,3,215,.041281138,.041992884,.6782918,.050533809,.029181495,0,.0021352314,.15302491,48012
48,014,BARRIKA,1100,813,2,811,3,808,287,82,0,43,87,441,23,1,129,.10110974,.10727497,.54377311,.053020962,.02836005,0,.0012330456,.15906289,48014
48,016,BERANGO,4764,3434,13,3421,35,3386,1330,532,0,218,598,1514,60,5,449,.15551008,.17480269,.44256064,.063724056,.017538732,0,.001461561,.13124818,48016
48,017,BERMEO,14149,10449,31,10418,19,10399,3700,339,2,291,670,7434,178,14,1447,.032539833,.064311765,.71357268,.027932424,.017085813,.00019197543,.001343828,.13889422,48017
48,018,BERRIATUA,945,681,0,681,0,681,264,7,0,12,6,398,30,1,226,.010279002,.0088105723,.58443463,.017621145,.044052862,0,.0014684288,.33186489,48018
48,021,BUSTURIA,1505,1145,2,1143,2,1141,360,52,0,46,96,703,27,0,216,.045494314,.083989501,.61504811,.04024497,.023622047,0,0,.18897638,48021
48,028,EA,714,609,1,608,1,607,105,10,0,13,3,406,12,0,162,.016447369,.0049342103,.66776317,.021381579,.019736841,0,0,.26644737,48028
48,030,ETXEBARRIA,638,514,1,513,1,512,124,4,0,7,4,303,10,0,183,.007797271,.007797271,.59064329,.013645224,.019493178,0,0,.35672516,48030
48,031,ELANTXOBE,416,356,0,356,0,356,60,5,0,6,7,253,7,0,78,.014044944,.019662922,.71067417,.016853932,.019662922,0,0,.21910113,48031
48,033,EREÑO,229,201,0,201,0,201,28,3,0,2,3,146,4,2,40,.014925373,.014925373,.72636819,.0099502485,.019900497,0,.0099502485,.19900498,48033
48,035,FRUIZ,321,259,0,259,0,259,62,16,0,4,7,170,4,0,58,.061776061,.027027028,.65637064,.015444015,.015444015,0,0,.22393823,48035
48,038,GAMIZ-FIKA,1037,855,4,851,9,842,182,46,0,22,28,585,20,2,138,.054054055,.032902468,.68742657,.025851939,.023501763,0,.0023501762,.16216215,48038
48,040,GATIKA,1151,891,10,881,8,873,260,37,0,27,56,583,23,0,146,.041997731,.063564129,.66174799,.030646993,.026106697,0,0,.16572078,48040
48,041,GAUTEGIZ ARTEAGA,724,624,2,622,1,621,100,30,0,20,32,402,22,0,115,.048231512,.051446944,.64630222,.03215434,.035369776,0,0,.18488745,48041
48,043,GORLIZ,3923,2962,9,2953,29,2924,961,275,0,178,324,1727,63,4,343,.093125634,.10971893,.58482897,.060277686,.021334236,0,.0013545547,.11615306,48043
48,044,GETXO,66836,49848,120,49728,462,49266,16988,14476,6,2270,8925,18824,782,125,3650,.2911036,.17947635,.37853926,.045648325,.015725547,.00012065637,.0025136743,.07339929,48044
48,046,GERNIKA-LUMO,12923,9938,22,9916,42,9874,2985,685,4,373,1023,5614,276,13,1852,.069080271,.1031666,.56615573,.037615974,.027833804,.00040338846,.0013110125,.18676886,48046
48,047,GIZABURUAGA,118,97,0,97,0,97,21,0,0,2,1,60,2,0,32,0,.010309278,.61855668,.020618556,.020618556,0,0,.3298969,48047
48,048,IBARRANGELU,498,415,0,415,0,415,83,11,0,4,11,297,11,0,80,.026506023,.026506023,.71566266,.0096385544,.026506023,0,0,.19277108,48048
48,049,ISPASTER,555,451,3,448,0,448,104,20,0,3,1,315,13,1,93,.044642858,.002232143,.703125,.0066964286,.029017856,0,.002232143,.20758928,48049
48,052,LARRABETZU,1376,1139,4,1135,8,1127,237,45,0,42,34,624,35,1,346,.039647575,.029955948,.54977971,.037004404,.030837005,0,.00088105729,.30484581,48052
48,053,LAUKIZ,791,647,3,644,1,643,144,91,0,14,47,424,3,2,57,.14130434,.072981365,.6583851,.021739131,.0046583852,0,.0031055901,.088509314,48053
48,054,LEIOA,23376,16254,61,16193,148,16045,7122,2827,6,1126,4016,6446,234,61,1225,.1745816,.2480084,.39807326,.069536217,.014450689,.00037053047,.0037670599,.075649969,48054
48,056,LEMOIZ,770,612,3,609,3,606,158,21,0,19,20,437,14,1,94,.034482758,.032840721,.71756977,.031198686,.022988506,0,.0016420361,.1543514,48056
48,057,LEKEITIO,6190,4881,9,4872,26,4846,1309,135,1,123,130,2756,149,4,1540,.027709359,.026683087,.56568146,.025246305,.030582923,.00020525452,.00082101807,.31609195,48057
48,060,MARKINA-XEMEIN,3927,2894,11,2883,12,2871,1033,81,0,84,87,1792,116,2,705,.028095733,.030176898,.62157476,.029136317,.040235866,0,.00069372181,.24453694,48060
48,061,MARURI-JATABE,686,536,4,532,0,532,150,41,0,29,35,360,13,0,53,.077067666,.065789476,.67669171,.054511279,.02443609,0,0,.09962406,48061
48,062,MENDATA,296,250,2,248,1,247,46,7,0,1,3,193,4,0,39,.028225806,.012096774,.77822578,.0040322579,.016129032,0,0,.15725806,48062
48,063,MENDEXA,314,257,2,255,0,255,57,5,0,4,4,121,7,1,113,.019607844,.015686275,.47450981,.015686275,.027450981,0,.0039215689,.44313726,48063
48,064,MEÑAKA,486,429,2,427,0,427,57,9,0,12,6,317,11,1,71,.021077283,.014051522,.74238878,.028103044,.025761124,0,.0023419203,.16627635,48064
48,066,MORGA,356,299,2,297,0,297,57,7,0,4,0,235,6,0,45,.023569023,0,.79124582,.013468013,.02020202,0,0,.15151516,48066
48,067,MUXIKA,1142,907,2,905,1,904,235,12,0,16,12,578,29,0,255,.013259669,.013259669,.63867402,.017679557,.032044198,0,0,.28176796,48067
48,068,MUNDAKA,1599,1337,3,1334,6,1328,262,27,0,31,45,956,23,2,241,.02023988,.033733133,.71664166,.023238381,.017241379,0,.0014992504,.18065967,48068
48,069,MUNGIA,11586,8619,20,8599,48,8551,2967,898,0,343,869,5437,153,14,805,.10443075,.10105826,.63228285,.03988836,.017792767,0,.0016280963,.093615539,48069
48,070,AULESTI,574,442,4,438,2,436,132,3,0,4,6,205,15,0,203,.006849315,.01369863,.46803653,.0091324197,.034246575,0,0,.46347031,48070
48,073,ONDARROA,7694,5613,26,5587,16,5571,2081,285,0,126,193,2632,208,1,2118,.051011276,.034544479,.47109362,.022552354,.037229281,0,.00017898693,.37909433,48073
48,076,SUKARRIETA,314,265,0,265,2,263,49,10,0,12,14,162,5,0,57,.03773585,.052830189,.61132073,.04528302,.018867925,0,0,.21509434,48076
48,077,PLENTZIA,3221,2516,12,2504,5,2499,705,278,0,124,226,1526,59,10,265,.11102236,.090255588,.60942495,.049520768,.023562301,0,.0039936104,.10583067,48077
48,079,ERRIGOITI,452,388,2,386,1,385,64,12,0,3,2,278,6,3,81,.031088082,.005181347,.72020727,.0077720205,.015544041,0,.0077720205,.20984456,48079
48,081,LEZAMA,1845,1441,1,1440,5,1435,404,81,0,63,107,954,25,1,200,.056249999,.074305557,.66250002,.043749999,.017361112,0,.00069444446,.1388889,48081
48,085,SOPELANA,9137,6349,17,6332,55,6277,2788,581,0,500,979,3076,146,14,968,.091756158,.1546115,.48578647,.078963995,.023057485,0,.0022109917,.15287429,48085
48,089,URDULIZ,2648,1962,3,1959,13,1946,686,164,0,74,252,1107,23,11,304,.083716184,.12863706,.56508422,.037774373,.011740684,0,.0056151096,.15518121,48089
48,901,DERIO,4236,3006,9,2997,24,2973,1230,343,1,157,837,1347,26,17,222,.11444778,.27927929,.44944945,.052385718,.0086753424,.00033366701,.0056723389,.074074075,48901
48,902,ERANDIO,19669,12458,32,12426,110,12316,7211,1541,6,668,3270,5491,102,39,1113,.12401416,.2631579,.44189602,.053758249,.0082085952,.00048285854,.0031385804,.089570254,48902
48,903,LOIU,1709,1366,10,1356,12,1344,343,210,0,28,92,909,14,2,89,.15486726,.067846611,.67035401,.020648967,.010324484,0,.0014749262,.065634221,48903
48,904,SONDIKA,3560,2794,8,2786,12,2774,766,328,0,96,422,1646,27,8,238,.11773151,.15147164,.59081119,.034458004,.0096913138,0,.0028715003,.085427135,48904
48,905,ZAMUDIO,2698,1998,8,1990,16,1974,700,196,1,61,245,1123,30,6,310,.098492466,.12311558,.56432164,.030653266,.015075377,.00050251256,.0030150753,.1557789,48905
48,906,FORUA,820,652,0,652,2,650,168,29,0,12,28,397,16,1,167,.044478528,.042944785,.60889572,.018404908,.024539877,0,.0015337423,.25613496,48906
48,907,KORTEZUBI,331,293,0,293,0,293,38,7,0,1,9,207,1,0,68,.023890786,.030716723,.70648462,.0034129692,.0034129692,0,0,.23208191,48907
48,908,MURUETA,226,176,0,176,0,176,50,3,0,5,3,130,7,0,28,.017045455,.017045455,.73863637,.028409092,.039772727,0,0,.15909091,48908
48,909,NABARNIZ,198,171,0,171,0,171,27,0,0,2,0,89,3,0,77,0,0,.52046782,.011695907,.01754386,0,0,.45029241,48909
48,911,AJANGIZ,361,312,0,312,1,311,49,0,0,4,2,164,13,0,128,0,.0064102565,.52564102,.012820513,.041666668,0,0,.41025642,48911
48,914,ARRATZU,307,265,0,265,0,265,42,2,0,6,2,159,5,0,91,.0075471699,.0075471699,.60000002,.02264151,.018867925,0,0,.34339622,48914
48,999,MUNICIPIO CERA BIZKAIA,20983,5079,2,5077,48,5029,15904,942,4,150,1158,2438,50,48,138,.18554264,.22808746,.48020485,.029545007,.0098483358,.00078786683,.0094544021,.027181406,48999
