prov,codmunicipio,ambito,censo,votantes,nulos_2012,vlidos_2012,blancos_2012,votoscand_2012,abstenciones_2012,eajpnv_2012,pp_2012,ebb_2012,pseeepsoe_2012,pacmaattka_2012,upyd_2012,equo_2012,iulv_2012,ebaz_2012,ehbildu_2012,id,share_pp_2012,share_pse_2012,share_eajpnv_2012,share_ebb_2012,share_upyd_2012,share_iulv_2012,share_ebaz_2012,share_equo_2012,share_ehbildu_2012
01,059,VITORIA-GASTEIZ,183640,117592,1764,115828,1734,114094,66048,25797,23921,1867,24756,534,4665,3696,3702,1885,22263,01059,.20652173,.21373071,.22271816,.016118728,.040275235,.031961184,.01627413,.031909384,.19220741
01,001,ALEGRÍA-DULANTZI,2016,1266,20,1246,33,1213,750,362,147,27,206,3,42,44,39,28,307,01001,.11797753,.16532905,.2905297,.021669341,.033707865,.031300161,.02247191,.035313003,.24638845
01,003,ARAMAIO,1199,889,3,886,4,882,310,270,8,13,26,1,3,7,8,5,539,01003,.0090293456,.029345373,.3047404,.014672686,.0033860046,.0090293456,.0056433408,.0079006776,.60835212
01,006,ARMIÑÓN,182,120,1,119,4,115,62,27,28,0,19,1,8,0,4,1,26,01006,.23529412,.15966387,.22689076,0,.067226894,.033613447,.0084033618,0,.2184874
01,008,ARRAZUA-UBARRUNDIA,789,532,1,531,7,524,257,178,85,13,67,4,16,10,6,7,136,01008,.16007534,.12617703,.33521658,.024482109,.030131826,.011299435,.013182675,.018832391,.25612053
01,009,ASPARRENA,1296,873,9,864,4,860,423,293,51,11,74,5,10,8,22,9,373,01009,.059027776,.085648149,.33912036,.012731481,.011574074,.025462963,.010416667,.0092592593,.43171296
01,011,BAÑOS DE EBRO / MAÑUETA,242,163,6,157,7,150,79,54,62,0,18,0,2,2,1,0,11,01011,.39490446,.11464968,.34394905,0,.012738854,.0063694268,0,.012738854,.070063695
01,013,BARRUNDIA,710,470,1,469,6,463,240,150,50,6,34,2,8,16,5,3,181,01013,.10660981,.072494671,.31982943,.012793177,.01705757,.010660981,.0063965884,.034115139,.3859275
01,014,BERANTEVILLA,383,272,6,266,4,262,111,80,72,5,39,0,13,5,6,2,39,01014,.2706767,.14661655,.30075186,.018796992,.04887218,.022556391,.0075187972,.018796992,.14661655
01,016,BERNEDO,455,245,11,234,6,228,210,88,44,0,15,0,9,1,5,2,63,01016,.18803419,.064102568,.37606838,0,.03846154,.021367522,.008547009,.0042735045,.26923078
01,017,CAMPEZO / KANPEZU,896,578,4,574,10,564,318,208,88,10,44,2,9,6,9,5,182,01017,.15331011,.076655053,.36236933,.017421603,.015679443,.015679443,.0087108016,.010452962,.31707317
01,018,ZIGOITIA,1396,936,14,922,13,909,460,289,108,13,87,5,19,41,20,5,320,01018,.11713666,.094360083,.31344903,.014099783,.020607375,.021691974,.0054229936,.044468548,.34707159
01,019,KRIPAN,154,123,0,123,0,123,31,81,16,0,5,0,0,1,0,0,20,01019,.1300813,.040650405,.65853661,0,0,0,0,.008130081,.16260162
01,020,KUARTANGO,319,238,1,237,3,234,81,104,23,0,8,0,2,1,1,1,93,01020,.097046413,.033755273,.43881857,0,.0084388182,.0042194091,.0042194091,.0042194091,.39240506
01,021,ELBURGO / BURGELU,468,312,6,306,1,305,156,115,57,2,25,5,12,9,9,6,62,01021,.18627451,.081699349,.375817,.0065359478,.039215688,.029411765,.019607844,.029411765,.20261438
01,022,ELCIEGO,821,538,12,526,9,517,283,111,134,9,138,1,19,9,19,6,68,01022,.25475284,.26235741,.21102661,.017110266,.036121674,.036121674,.011406844,.017110266,.12927757
01,023,ELVILLAR / BILAR,286,192,1,191,4,187,94,71,58,1,20,0,4,0,3,0,30,01023,.30366492,.10471204,.37172773,.0052356021,.020942409,.015706806,0,0,.15706806
01,027,IRURAIZ-GAUNA,423,262,4,258,3,255,161,90,35,3,25,2,8,4,3,5,79,01027,.13565892,.096899226,.3488372,.011627907,.031007752,.011627907,.019379845,.015503876,.30620155
01,028,LABASTIDA / BASTIDA,1099,690,5,685,12,673,409,164,200,3,96,1,21,9,23,5,150,01028,.29197079,.14014599,.23941606,.0043795621,.030656934,.033576641,.00729927,.013138686,.21897811
01,030,LAGRÁN,155,108,1,107,1,106,47,36,34,0,15,0,1,2,1,2,14,01030,.31775701,.14018692,.33644861,0,.0093457941,.0093457941,.018691588,.018691588,.13084112
01,031,LAGUARDIA,1219,788,37,751,6,745,431,195,263,10,88,4,20,3,16,3,140,01031,.35019973,.1171771,.25965381,.013315579,.026631158,.021304926,.003994674,.003994674,.18641812
01,032,LANCIEGO / LANTZIEGO,530,359,10,349,1,348,171,115,94,4,54,2,9,1,2,3,61,01032,.26934096,.15472779,.32951289,.011461318,.025787966,.0057306592,.0085959882,.0028653296,.17478511
01,033,LAPUEBLA DE LABARCA,667,480,5,475,3,472,187,219,86,9,70,2,6,2,10,1,67,01033,.18105263,.14736842,.46105263,.018947368,.012631579,.021052632,.0021052631,.0042105261,.14105263
01,034,LEZA,162,113,2,111,2,109,49,49,10,1,19,0,0,1,1,0,28,01034,.090090089,.17117117,.44144145,.0090090092,0,.0090090092,0,.0090090092,.25225225
01,037,ARRAIA-MAEZTU,624,403,5,398,1,397,221,153,73,2,27,1,3,4,6,5,121,01037,.18341708,.067839198,.38442212,.0050251256,.0075376886,.015075377,.012562814,.010050251,.30402011
01,039,MOREDA DE ÁLAVA / MOREDA ARABA,212,161,4,157,3,154,51,53,30,3,41,3,5,2,2,1,14,01039,.19108281,.26114649,.33757961,.019108281,.031847134,.012738854,.0063694268,.012738854,.089171976
01,041,NAVARIDAS,157,94,1,93,4,89,63,35,29,0,7,0,4,5,0,4,5,01041,.31182796,.07526882,.37634408,0,.043010753,0,.043010753,.053763442,.053763442
01,043,OYÓN-OION,2307,1377,27,1350,14,1336,930,285,372,17,261,3,53,14,49,5,270,01043,.27555555,.19333333,.21111111,.012592592,.039259259,.036296297,.0037037036,.01037037,.2
01,044,PEÑACERRADA-URIZAHARRA,236,157,1,156,1,155,79,49,32,3,15,0,3,1,6,3,43,01044,.20512821,.096153848,.31410256,.01923077,.01923077,.03846154,.01923077,.0064102565,.27564102
01,046,ERRIBERA GOITIA / RIBERA ALTA,606,382,5,377,6,371,224,144,72,2,43,2,13,8,6,6,73,01046,.19098143,.11405835,.38196287,.0053050397,.034482758,.01591512,.01591512,.021220159,.19363396
01,047,RIBERA BAJA / ERRIBERA BEITIA,938,556,12,544,12,532,382,156,144,6,122,0,16,9,14,6,59,01047,.2647059,.22426471,.28676471,.011029412,.029411765,.025735294,.011029412,.016544119,.10845588
01,049,AÑANA,141,104,0,104,1,103,37,44,16,0,14,1,0,1,1,1,25,01049,.15384616,.13461539,.42307693,0,0,.009615385,.009615385,.009615385,.24038461
01,051,SALVATIERRA / AGURAIN,3666,2237,18,2219,19,2200,1429,797,169,33,231,6,37,36,47,29,806,01051,.076160431,.10410095,.35917079,.014871564,.016674178,.021180712,.01306895,.016223524,.36322668
01,052,SAMANIEGO,235,176,2,174,2,172,59,72,14,1,38,0,1,2,2,1,41,01052,.080459774,.21839081,.41379312,.0057471264,.0057471264,.011494253,.0057471264,.011494253,.23563218
01,053,SAN MILLÁN / DONEMILIAGA,600,350,4,346,3,343,250,128,31,7,13,0,5,10,4,2,140,01053,.089595377,.037572253,.36994219,.020231213,.014450867,.011560693,.0057803467,.028901733,.40462428
01,054,URKABUSTAIZ,944,684,5,679,15,664,260,210,47,9,51,1,3,17,8,9,309,01054,.06921944,.075110458,.30927834,.013254787,.0044182623,.011782032,.013254787,.025036819,.45508102
01,055,VALDEGOVÍA / GAUBEA,878,563,16,547,12,535,315,183,145,6,64,2,7,9,7,5,106,01055,.26508227,.11700183,.33455211,.010968922,.012797075,.012797075,.0091407681,.016453382,.19378428
01,056,HARANA / VALLE DE ARANA,246,161,0,161,1,160,85,95,19,1,12,1,2,1,0,1,28,01056,.11801242,.074534163,.59006214,.0062111802,.01242236,0,.0062111802,.0062111802,.17391305
01,057,VILLABUENA DE ÁLAVA / ESKUERNAGA,255,193,1,192,1,191,62,83,26,1,7,0,3,1,0,1,69,01057,.13541667,.036458332,.43229166,.0052083335,.015625,0,.0052083335,.0052083335,.359375
01,058,LEGUTIO,1336,847,5,842,7,835,489,243,42,11,78,1,14,13,17,5,408,01058,.049881235,.092636578,.28859857,.013064133,.016627079,.020190023,.0059382422,.01543943,.48456058
01,060,YÉCORA / IEKORA,209,142,4,138,1,137,67,41,61,0,11,2,6,1,3,1,10,01060,.442029,.079710148,.29710144,0,.043478262,.021739131,.0072463769,.0072463769,.072463766
01,061,ZALDUONDO,151,127,2,125,3,122,24,51,4,2,10,2,0,2,1,0,46,01061,.032000002,.079999998,.40799999,.016000001,0,.0080000004,0,.016000001,.368
01,062,ZAMBRANA,330,193,1,192,4,188,137,54,61,0,34,0,3,2,6,0,28,01062,.31770834,.17708333,.28125,0,.015625,.03125,0,.010416667,.14583333
01,063,ZUIA,1809,1281,17,1264,38,1226,528,447,144,21,135,2,27,37,13,24,370,01063,.11392405,.1068038,.35363925,.016613925,.021360759,.01028481,.018987341,.029272152,.29272151
01,901,IRUÑA OKA / IRUÑA DE OCA,2269,1423,21,1402,28,1374,846,313,278,22,337,9,52,41,48,26,241,01901,.19828816,.2403709,.22325249,.015691869,.037089873,.034236804,.018544937,.029243937,.17189729
01,902,LANTARÓN,772,468,6,462,7,455,304,159,99,5,55,1,11,11,16,6,91,01902,.21428572,.11904762,.34415585,.010822511,.023809524,.034632035,.012987013,.023809524,.1969697
01,002,AMURRIO,8082,5711,83,5628,45,5583,2371,2209,466,116,778,23,76,46,118,54,1672,01002,.082800284,.13823739,.39250177,.02061123,.013503909,.020966595,.0095948828,.0081734182,.297086
01,004,ARTZINIEGA,1418,986,27,959,10,949,432,390,132,16,84,6,19,11,7,15,267,01004,.13764338,.087591238,.40667361,.016684046,.019812305,.00729927,.015641293,.011470282,.27841502
01,010,AYALA / AIARA,2264,1623,25,1598,21,1577,641,690,142,21,126,3,18,10,30,12,517,01010,.088861078,.078848563,.43178973,.013141427,.01126408,.018773466,.0075093866,.0062578223,.32352942
01,036,LAUDIO / LLODIO,15218,10008,108,9900,119,9781,5210,3484,942,163,1709,23,151,101,235,99,2842,01036,.095151514,.17262626,.3519192,.016464647,.015252525,.023737373,.0099999998,.01020202,.28707072
01,042,OKONDO,907,669,9,660,8,652,238,304,39,9,16,0,3,1,9,0,269,01042,.059090909,.024242423,.46060607,.013636364,.0045454544,.013636364,0,.0015151515,.40757576
01,999,MUNICIPIO CERA ARABA,4677,404,15,389,7,382,4273,98,71,4,91,3,12,13,9,4,71,01999,.18251929,.23393317,.25192803,.010282776,.03084833,.023136247,.010282776,.033419024,.18251929
01,040,HERNANI,15108,9491,67,9424,136,9288,5617,2203,456,117,1490,31,79,76,230,92,4488,01040,.048387095,.15810697,.23376486,.01241511,.0083828522,.024405772,.0097623086,.0080645159,.47623089
01,069,DONOSTIA-SAN SEBASTIÁN,146677,96915,492,96423,1379,95044,49762,28148,14825,1345,21626,454,2368,878,2575,1252,21193,01069,.15374963,.22428259,.29192206,.013948954,.024558457,.026705246,.012984454,.0091057112,.21979196
01,072,URNIETA,4647,2832,16,2816,43,2773,1815,932,149,29,639,12,43,19,82,21,833,01072,.052911934,.22691761,.33096591,.010298296,.015269887,.029119318,.0074573862,.0067471592,.29580966
01,073,USURBIL,4669,3199,23,3176,44,3132,1470,799,94,36,313,11,20,12,53,24,1759,01073,.029596977,.098551638,.25157431,.011335013,.0062972293,.016687658,.007556675,.0037783375,.55384129
01,902,LASARTE-ORIA,14137,9333,50,9283,100,9183,4804,1989,855,130,3233,50,197,66,255,124,2241,01902,.092103846,.34827104,.21426263,.014004094,.021221587,.027469568,.013357751,.0071097706,.24140903
01,903,ASTIGARRAGA,3811,2418,13,2405,49,2356,1393,843,107,42,252,9,21,25,46,50,957,01903,.044490643,.1047817,.35051975,.017463617,.0087318085,.019126819,.02079002,.01039501,.397921
01,036,HONDARRIBIA,12753,8404,49,8355,138,8217,4349,3911,629,115,1036,22,98,54,180,111,2033,01036,.075284258,.12399761,.46810293,.013764213,.011729503,.021543985,.013285458,.0064631957,.24332735
01,045,IRUN,46524,28235,224,28011,448,27563,18289,7478,3536,492,8691,144,829,266,1184,336,4472,01045,.12623613,.31027097,.26696655,.017564528,.029595517,.042269107,.011995288,.0094962697,.15965156
01,053,LEZO,4826,2744,28,2716,43,2673,2082,716,101,51,400,8,50,15,82,32,1210,01053,.03718704,.1472754,.26362297,.018777614,.018409425,.030191459,.011782032,.0055228276,.44550809
01,063,OIARTZUN,7874,5358,13,5345,48,5297,2516,1361,164,53,317,10,20,32,77,34,3227,01063,.03068288,.059307765,.25463051,.0099158091,.0037418148,.014405987,.006361085,.0059869038,.60374182
01,064,PASAIA,12384,7124,60,7064,127,6937,5260,1913,525,117,1435,53,126,63,297,128,2247,01064,.074320495,.2031427,.27080974,.016562853,.017836919,.042044166,.018120045,.0089184595,.31809172
01,067,ERRENTERIA,31031,18573,120,18453,239,18214,12458,3935,1306,341,5293,129,383,124,792,231,5605,01067,.070774399,.28683683,.21324445,.018479381,.020755433,.042919852,.012518289,.0067197746,.30374464
01,001,ABALTZISKETA,244,172,1,171,0,171,72,78,1,1,1,0,0,0,0,1,89,01001,.0058479533,.0058479533,.45614034,.0058479533,0,0,.0058479533,0,.52046782
01,002,ADUNA,345,244,4,240,6,234,101,58,4,1,9,2,1,2,1,2,154,01002,.016666668,.037500001,.24166666,.0041666669,.0041666669,.0041666669,.0083333338,.0083333338,.64166665
01,004,ALBIZTUR,255,149,0,149,5,144,106,78,0,2,8,0,0,1,0,0,55,01004,0,.053691275,.52348995,.013422819,0,0,0,.0067114094,.36912751
01,005,ALEGIA,1325,881,2,879,4,875,444,278,17,17,54,1,1,4,14,4,483,01005,.019340159,.061433446,.31626847,.019340159,.0011376564,.01592719,.0045506256,.0045506256,.54948807
01,006,ALKIZA,284,178,3,175,1,174,106,75,0,2,3,0,0,1,2,0,91,01006,0,.017142856,.42857143,.011428571,0,.011428571,0,.0057142857,.51999998
01,007,ALTZO,299,208,2,206,3,203,91,70,0,0,1,0,1,2,0,0,129,01007,0,.004854369,.33980581,0,.004854369,0,0,.009708738,.62621361
01,008,AMEZKETA,755,480,0,480,5,475,275,145,11,4,10,0,1,1,6,2,295,01008,.022916667,.020833334,.30208334,.0083333338,.0020833334,.0125,.0041666669,.0020833334,.61458331
01,009,ANDOAIN,11724,7354,35,7319,99,7220,4370,1867,476,121,1836,29,117,61,261,100,2325,01009,.065036207,.25085396,.25508949,.016532313,.015985791,.03566061,.013663068,.0083344718,.31766635
01,010,ANOETA,1395,994,6,988,10,978,401,291,45,17,107,2,2,6,18,16,473,01010,.045546558,.1082996,.29453442,.017206477,.0020242915,.018218623,.016194332,.0060728746,.47874495
01,012,ARAMA,149,112,0,112,1,111,37,40,1,1,4,0,0,0,1,0,64,01012,.0089285718,.035714287,.35714287,.0089285718,0,.0089285718,0,0,.5714286
01,014,ASTEASU,1108,680,0,680,5,675,428,208,15,7,44,0,0,1,9,2,389,01014,.022058824,.064705886,.30588236,.010294118,0,.013235294,.0029411765,.0014705883,.5720588
01,015,ATAUN,1310,1015,3,1012,14,998,295,374,1,4,12,0,1,1,4,2,599,01015,.00098814233,.011857707,.36956522,.0039525693,.00098814233,.0039525693,.0019762847,.00098814233,.59189725
01,019,BEASAIN,10113,6509,48,6461,81,6380,3604,2537,318,82,1098,25,62,54,148,44,1993,01019,.049218386,.16994274,.39266369,.012691534,.0095960377,.02290667,.0068100914,.0083578397,.3084662
01,021,BELAUNTZA,214,118,0,118,1,117,96,41,3,0,5,0,0,0,0,0,67,01021,.025423728,.042372882,.34745762,0,0,0,0,0,.56779659
01,022,BERASTEGI,836,546,4,542,7,535,290,204,8,5,22,0,0,1,0,3,292,01022,.014760148,.040590405,.37638375,.0092250919,0,0,.0055350554,.0018450185,.5387454
01,023,BERROBI,445,280,0,280,4,276,165,67,8,7,11,0,1,2,4,1,175,01023,.028571429,.039285716,.23928571,.025,.0035714286,.014285714,.0035714286,.0071428572,.625
01,025,ZEGAMA,1162,832,5,827,7,820,330,365,3,6,8,4,1,2,8,4,418,01025,.0036275694,.0096735191,.4413543,.0072551388,.0012091899,.0096735191,.0048367595,.0024183798,.50544137
01,026,ZERAIN,211,177,2,175,1,174,34,81,0,0,0,0,1,1,0,0,89,01026,0,0,.46285716,0,.0057142857,0,0,.0057142857,.50857145
01,028,ZIZURKIL,2245,1440,7,1433,31,1402,805,439,58,16,189,4,9,2,34,5,639,01028,.04047453,.13189113,.30635032,.011165387,.0062805302,.023726448,.0034891835,.0013956734,.44591767
01,031,ELDUAIN,181,121,0,121,0,121,60,44,1,0,1,0,0,2,1,0,72,01031,.0082644625,.0082644625,.36363637,0,0,.0082644625,0,.016528925,.59504133
01,035,EZKIO-ITSASO,493,338,0,338,3,335,155,123,2,1,5,0,0,0,5,0,199,01035,.0059171598,.0147929,.36390531,.0029585799,0,.0147929,0,0,.5887574
01,037,GAINTZA,102,75,0,75,3,72,27,33,0,2,1,1,0,1,0,0,34,01037,0,.013333334,.44,.026666667,0,0,0,.013333334,.45333335
01,038,GABIRIA,383,290,3,287,2,285,93,116,1,0,4,1,0,0,1,0,162,01038,.0034843206,.013937282,.40418118,0,0,.0034843206,0,0,.56445992
01,041,HERNIALDE,277,156,0,156,0,156,121,59,1,0,3,0,1,5,1,2,84,01041,.0064102565,.01923077,.37820512,0,.0064102565,.0064102565,.012820513,.032051284,.53846157
01,042,IBARRA,3352,2097,7,2090,27,2063,1255,638,89,41,287,5,12,11,45,19,905,01042,.042583734,.13732058,.30526316,.019617224,.005741627,.021531101,.0090909088,.0052631581,.43301436
01,043,IDIAZABAL,1761,1248,5,1243,16,1227,513,582,31,9,33,3,3,7,6,4,546,01043,.024939662,.026548672,.46822205,.0072405469,.0024135157,.0048270314,.003218021,.0056315367,.43925986
01,044,IKAZTEGIETA,367,247,0,247,2,245,120,79,3,0,13,4,0,0,2,0,142,01044,.012145749,.052631579,.31983805,0,0,.0080971662,0,0,.57489878
01,046,IRURA,1159,788,4,784,19,765,371,283,25,13,69,1,12,5,12,4,339,01046,.031887755,.088010207,.36096939,.016581632,.015306123,.015306123,.0051020407,.0063775512,.43239796
01,047,ITSASONDO,484,325,4,321,1,320,159,107,6,1,19,3,1,1,2,0,175,01047,.018691588,.059190031,.33333334,.0031152647,.0031152647,.0062305294,0,.0031152647,.54517132
01,048,LARRAUL,174,110,0,110,2,108,64,23,1,2,6,0,0,1,1,1,72,01048,.0090909088,.054545455,.2090909,.018181818,0,.0090909088,.0090909088,.0090909088,.65454543
01,049,LAZKAO,4098,2700,12,2688,46,2642,1398,909,74,43,386,7,17,13,33,13,1141,01049,.027529761,.14360119,.33816963,.015997024,.0063244049,.012276785,.0048363097,.0048363097,.42447916
01,050,LEABURU,282,201,2,199,2,197,81,67,3,0,0,0,0,0,0,0,127,01050,.015075377,0,.33668342,0,0,0,0,0,.63819093
01,051,LEGAZPI,6993,4671,46,4625,53,4572,2322,1639,256,94,838,10,37,66,125,30,1456,01051,.05535135,.18118919,.35437837,.020324325,.0080000004,.027027028,.0064864866,.01427027,.31481081
01,052,LEGORRETA,1145,799,2,797,12,785,346,292,23,8,59,0,1,2,13,8,377,01052,.028858218,.074027605,.3663739,.010037641,.0012547051,.016311167,.010037641,.0025094103,.47302383
01,054,LIZARTZA,465,350,0,350,7,343,115,67,9,0,1,0,0,0,4,0,262,01054,.025714286,.0028571428,.19142857,0,0,.011428571,0,0,.74857146
01,057,MUTILOA,192,121,0,121,2,119,71,40,0,0,1,0,0,0,1,1,76,01057,0,.0082644625,.33057851,0,0,.0082644625,.0082644625,0,.6280992
01,058,OLABERRIA,765,509,1,508,5,503,256,170,35,4,96,3,4,4,16,0,171,01058,.068897635,.18897638,.33464566,.0078740157,.0078740157,.031496063,0,.0078740157,.33661416
01,060,OREXA,89,80,2,78,1,77,9,2,0,0,0,0,0,0,0,0,75,01060,0,0,.025641026,0,0,0,0,0,.96153843
01,062,ORMAIZTEGI,990,714,0,714,10,704,276,300,24,7,30,0,3,3,4,8,321,01062,.033613447,.042016808,.42016807,.0098039219,.0042016809,.005602241,.011204482,.0042016809,.44957983
01,070,SEGURA,1100,833,3,830,5,825,267,329,5,3,18,3,0,2,2,0,463,01070,.0060240962,.021686748,.39638555,.0036144578,0,.0024096386,0,.0024096386,.55783135
01,071,TOLOSA,14599,9671,46,9625,123,9502,4928,3780,465,120,1051,26,39,73,186,78,3661,01071,.048311688,.10919481,.39272729,.012467532,.004051948,.019324675,.0081038959,.0075844154,.38036364
01,075,VILLABONA,4397,2816,14,2802,49,2753,1581,917,113,28,338,8,17,8,69,21,1224,01075,.040328339,.12062813,.32726625,.0099928621,.0060670949,.024625268,.0074946466,.0028551035,.43683085
01,076,ORDIZIA,6956,4679,22,4657,77,4580,2277,1576,266,56,709,15,26,32,149,30,1700,01076,.057118315,.15224393,.33841529,.012024908,.0055829934,.031994846,.0064419154,.0068713767,.36504188
01,077,URRETXU,5334,3659,18,3641,46,3595,1675,1296,174,71,734,13,24,16,117,31,1110,01077,.047789071,.20159297,.35594618,.019500138,.0065915957,.03213403,.0085141445,.0043943971,.30486131
01,078,ZALDIBIA,1156,889,5,884,10,874,267,216,7,5,44,1,1,2,10,3,581,01078,.0079185525,.049773756,.24434389,.0056561087,.0011312218,.011312217,.0033936652,.0022624435,.65723979
01,080,ZUMARRAGA,8109,5199,40,5159,62,5097,2910,1482,345,96,1625,23,42,23,172,23,1243,01080,.066873424,.31498352,.28726497,.018608257,.0081411125,.033339795,.0044582281,.0044582281,.24093817
01,904,BALIARRAIN,103,59,0,59,1,58,44,9,0,0,0,1,0,0,0,0,48,01904,0,0,.15254237,0,0,0,0,0,.81355929
01,905,ORENDAIN,139,107,0,107,1,106,32,32,0,0,1,0,0,1,0,1,70,01905,0,.0093457941,.29906541,0,0,0,.0093457941,.0093457941,.65420562
01,906,ALTZAGA,116,91,0,91,1,90,25,34,0,1,2,0,0,1,2,0,49,01906,0,.021978023,.37362638,.010989011,0,.021978023,0,.010989011,.53846157
01,907,GAZTELU,138,105,4,101,1,100,33,31,0,0,2,1,0,1,0,0,65,01907,0,.01980198,.30693069,0,0,0,0,.0099009899,.64356434
20,003,AIZARNAZABAL,553,380,0,380,4,376,173,120,0,1,6,1,1,0,1,1,243,20003,0,.015789473,.31578946,.0026315791,.0026315791,.0026315791,.0026315791,0,.63947368
20,011,ANTZUOLA,1692,1271,5,1266,7,1259,421,402,24,14,124,0,3,5,22,4,660,20011,.018957347,.097946286,.31753555,.011058452,.0023696683,.017377567,.0031595577,.0039494471,.52132702
20,013,ARETXABALETA,5389,3679,35,3644,27,3617,1710,1250,132,61,497,6,17,34,117,12,1479,20013,.036223929,.13638858,.34302965,.016739847,.0046652029,.032107573,.0032930844,.0093304059,.40587267
20,016,AIA,1527,1013,5,1008,4,1004,514,497,9,4,15,3,2,7,9,10,448,20016,.0089285718,.014880952,.49305555,.0039682542,.0019841271,.0089285718,.0099206353,.0069444445,.44444445
20,017,AZKOITIA,8587,5872,28,5844,42,5802,2715,2428,246,62,628,15,26,22,88,29,2238,20017,.042094454,.10746064,.41546887,.010609171,.0044490076,.015058179,.0049623544,.0037645448,.38295689
20,018,AZPEITIA,11064,7776,37,7739,68,7671,3288,3326,190,42,368,5,25,8,78,23,3597,20018,.024550976,.047551364,.42977127,.0054270579,.0032303915,.010078821,.0029719602,.0010337253,.46478873
20,020,BEIZAMA,139,91,0,91,1,90,48,36,1,0,0,2,0,1,0,0,50,20020,.010989011,0,.3956044,0,0,0,0,.010989011,.54945058
20,024,BIDEGOIAN,397,253,1,252,1,251,144,74,9,6,2,2,1,1,2,0,153,20024,.035714287,.0079365084,.29365081,.023809524,.0039682542,.0079365084,0,.0039682542,.60714287
20,027,ZESTOA,2797,1924,6,1918,20,1898,873,748,19,18,71,4,6,4,18,8,996,20027,.0099061523,.037017725,.38998958,.0093847755,.0031282585,.0093847755,.0041710115,.0020855058,.51929092
20,029,DEBA,4266,3042,13,3029,35,2994,1224,1213,101,49,254,7,19,15,59,16,1256,20029,.03334434,.083856061,.40046221,.016176956,.0062726974,.019478375,.0052822712,.0049521294,.41465831
20,030,EIBAR,22013,14517,82,14435,182,14253,7496,4250,1150,236,3954,39,124,99,415,107,3839,20030,.079667471,.27391756,.29442328,.016349152,.0085902316,.028749567,.0074125389,.0068583302,.26595083
20,032,ELGOIBAR,8902,6036,41,5995,70,5925,2866,2328,354,56,988,6,38,24,112,50,1959,20032,.059049208,.164804,.38832361,.0093411179,.0063386154,.018682236,.0083402833,.0040033362,.3267723
20,033,ELGETA,874,668,7,661,5,656,206,254,14,8,17,0,1,6,18,4,333,20033,.02118003,.025718609,.38426626,.012102874,.0015128592,.027231468,.006051437,.009077156,.50378215
20,034,ESKORIATZA,3169,2031,9,2022,11,2011,1138,636,64,38,407,3,4,19,85,10,734,20034,.031651828,.20128585,.31454006,.018793274,.0019782393,.042037588,.0049455985,.0093966369,.36300692
20,039,GETARIA,2017,1571,1,1570,14,1556,446,701,24,6,43,2,3,2,14,12,748,20039,.015286624,.027388535,.44649681,.0038216561,.0019108281,.0089171976,.0076433122,.0012738854,.47643313
20,055,ARRASATE / MONDRAGON,17704,11394,72,11322,123,11199,6310,3361,561,207,2272,23,56,69,440,61,4110,20055,.04954955,.20067126,.29685569,.018282989,.0049461224,.038862392,.0053877407,.0060943295,.36301008
20,056,MUTRIKU,4002,2688,17,2671,45,2626,1314,1104,83,36,122,6,1,34,24,6,1204,20056,.031074503,.045675777,.41332835,.013478098,.00037439162,.0089853983,.0022463496,.012729315,.45076752
20,059,OÑATI,8846,6408,19,6389,50,6339,2438,2463,197,74,423,1,7,27,97,31,3010,20059,.030834246,.066207543,.38550633,.011582407,.0010956331,.015182344,.0048520896,.0042260136,.47112224
20,061,ORIO,4047,2729,9,2720,26,2694,1318,1302,55,29,175,5,2,14,46,32,1030,20061,.020220589,.064338237,.47867647,.010661765,.00073529413,.016911766,.011764706,.005147059,.37867647
20,065,SORALUZE-PLACENCIA DE LAS ARMAS,3112,2072,8,2064,21,2043,1040,613,158,22,407,5,11,4,34,13,775,20065,.076550387,.19718993,.29699612,.010658915,.0053294576,.016472869,.0062984498,.0019379845,.3754845
20,066,ERREZIL,466,326,6,320,0,320,140,95,0,0,1,0,0,1,2,0,221,20066,0,.003125,.296875,0,0,.0062500001,0,.003125,.69062501
20,068,LEINTZ-GATZAGA,200,122,0,122,1,121,78,38,0,0,1,0,0,1,2,0,79,20068,0,.0081967209,.3114754,0,0,.016393442,0,.0081967209,.64754099
20,074,BERGARA,11612,7981,49,7932,83,7849,3631,2885,240,114,969,18,18,58,173,49,3306,20074,.030257186,.12216339,.3637166,.014372163,.002269289,.021810388,.0061775087,.0073121535,.41679275
20,079,ZARAUTZ,17258,11709,67,11642,146,11496,5549,4760,747,99,1479,30,103,89,233,131,3781,20079,.064164236,.12704003,.40886447,.0085036932,.0088472767,.020013744,.011252362,.0076447348,.32477239
20,081,ZUMAIA,7393,4965,34,4931,54,4877,2428,1887,173,65,694,9,29,39,110,43,1816,20081,.035084162,.14074224,.38268101,.01318191,.00588116,.022307849,.0087203411,.0079091461,.36828229
20,901,MENDARO,1458,970,6,964,3,961,488,405,34,8,110,3,12,12,19,6,351,20901,.035269711,.11410788,.42012447,.0082987556,.012448133,.019709544,.0062240665,.012448133,.36410788
20,999,MUNICIPIO CERA GIPUZKOA,21692,1935,25,1910,10,1900,19757,471,201,19,365,21,50,35,70,17,636,20999,.1052356,.19109948,.24659686,.0099476436,.02617801,.036649216,.0089005232,.018324608,.3329843
48,020,BILBAO,275318,178923,1095,177828,2347,175481,96395,64817,29481,2566,34844,713,4222,1747,4655,2200,27874,48020,.16578379,.19594215,.36449265,.014429674,.023742042,.02617698,.012371505,.0098241,.15674697
48,002,ABANTO Y CIÉRVANA-ABANTO ZIERBENA,7968,5082,66,5016,92,4924,2886,2010,194,112,1109,17,49,44,190,29,1120,48002,.038676236,.22109251,.40071771,.022328548,.0097687403,.037878789,.0057814992,.0087719299,.22328548
48,008,ARTZENTALES,601,441,14,427,4,423,160,273,14,5,17,2,0,2,4,1,104,48008,.032786883,.039812647,.63934427,.011709602,0,.0093676811,.0023419203,.0046838406,.24355972
48,013,BARAKALDO,80765,49393,455,48938,731,48207,31372,14408,5971,1132,14280,190,1247,362,2163,484,7263,48013,.12201153,.29179779,.29441333,.023131309,.02548122,.044198781,.0098900646,.0073971148,.14841227
48,022,KARRANTZA HARANA / VALLE DE CARRANZA,2405,1547,12,1535,18,1517,858,929,61,24,118,2,4,3,11,6,346,48022,.039739415,.076872967,.60521173,.015635179,.0026058631,.0071661239,.0039087948,.0019543974,.22540717
48,037,GALDAMES,710,529,3,526,7,519,181,297,13,7,31,1,1,6,3,2,156,48037,.024714829,.058935363,.56463879,.013307985,.0019011407,.0057034222,.0038022813,.011406844,.29657796
48,042,GORDEXOLA,1390,1072,21,1051,7,1044,318,620,107,28,86,2,15,6,12,7,145,48042,.1018078,.081826828,.58991438,.026641294,.014272122,.011417697,.0066603236,.0057088486,.13796385
48,045,GÜEÑES,5093,3786,55,3731,48,3683,1307,1895,171,72,464,6,39,25,29,18,940,48045,.045832217,.12436344,.50790673,.019297775,.010452962,.0077727153,.0048244437,.0067006163,.25194317
48,051,LANESTOSA,219,155,1,154,4,150,64,65,17,1,24,1,3,0,1,1,34,48051,.11038961,.15584415,.42207792,.0064935065,.019480519,.0064935065,.0064935065,0,.22077923
48,071,MUSKIZ,6117,4151,55,4096,50,4046,1966,1793,173,91,772,18,33,23,134,33,934,48071,.042236328,.18847656,.43774414,.022216797,.0080566406,.032714844,.0080566406,.0056152344,.22802734
48,078,PORTUGALETE,39454,25123,229,24894,330,24564,14331,7410,2874,624,7725,85,519,212,997,206,3635,48078,.1154495,.31031573,.29766208,.025066281,.020848397,.04004981,.0082750861,.0085161086,.14601912
48,080,VALLE DE TRÁPAGA-TRAPAGARAN,10067,6476,86,6390,91,6299,3591,2349,398,104,1763,26,90,21,256,44,1183,48080,.06228482,.27589986,.36760563,.01627543,.014084507,.040062599,.0068857591,.003286385,.18513303
48,082,SANTURTZI,38338,23854,188,23666,351,23315,14484,8335,2213,497,6154,71,358,142,944,171,4179,48082,.093509674,.26003549,.35219303,.021000592,.015127187,.039888449,.0072255558,.0060001691,.17658244
48,083,ORTUELLA,6998,4489,57,4432,65,4367,2509,1627,185,80,1214,19,52,19,166,29,925,48083,.041741878,.27391696,.36710289,.018050542,.011732852,.037454873,.0065433211,.0042870035,.20870939
48,084,SESTAO,23296,14127,141,13986,194,13792,9169,4405,1338,356,4172,56,155,78,646,159,2261,48084,.095667094,.2982983,.31495783,.025454026,.011082511,.046189047,.011368511,.0055770054,.16166165
48,086,SOPUERTA,2068,1408,10,1398,17,1381,660,657,55,22,150,3,15,8,27,9,422,48086,.039341915,.10729614,.46995708,.015736766,.010729614,.019313306,.0064377682,.0057224608,.3018598
48,087,TRUCIOS-TURTZIOZ,463,357,3,354,4,350,106,236,14,0,22,2,2,0,2,3,68,48087,.039548021,.062146891,.66666669,0,.0056497175,.0056497175,.0084745763,0,.19209039
48,090,BALMASEDA,6146,4414,88,4326,44,4282,1732,2135,245,65,841,18,42,20,89,34,759,48090,.056634303,.19440591,.4935275,.015025428,.009708738,.020573277,.0078594545,.0046232087,.17545076
48,096,ZALLA,6658,4828,96,4732,61,4671,1830,2599,220,110,608,17,52,17,61,16,924,48096,.046491969,.1284869,.54923922,.023245985,.010989011,.012890955,.0033812341,.0035925612,.19526628
48,912,ALONSOTEGI,2310,1753,24,1729,20,1709,557,879,84,31,215,2,14,3,34,12,422,48912,.048582997,.12434933,.50838637,.017929439,.0080971662,.019664546,.0069404282,.001735107,.24407172
48,913,ZIERBENA,1261,934,19,915,16,899,327,476,34,16,76,4,6,3,18,5,258,48913,.037158471,.083060108,.52021855,.017486339,.0065573771,.019672131,.0054644807,.0032786885,.28196722
48,001,ABADIÑO,5846,3851,26,3825,27,3798,1995,1147,272,48,709,13,28,14,87,17,1421,48001,.071111113,.18535948,.29986927,.012549019,.0073202616,.022745099,.0044444446,.0036601308,.37150326
48,003,AMOREBIETA-ETXANO,14175,9924,101,9823,70,9753,4251,4054,396,149,1423,29,77,74,232,75,3152,48003,.040313549,.1448641,.41270489,.015168482,.0078387456,.023618039,.0076351422,.0075333402,.32087958
48,005,ARAKALDO,91,56,0,56,1,55,35,24,1,0,3,0,0,0,1,0,26,48005,.017857144,.053571429,.42857143,0,0,.017857144,0,0,.4642857
48,006,ARANTZAZU,287,248,1,247,4,243,39,117,3,0,2,1,1,0,0,1,117,48006,.012145749,.0080971662,.47368422,0,.0040485831,0,.0040485831,0,.47368422
48,009,ARRANKUDIAGA,763,610,2,608,4,604,153,283,18,7,14,0,0,3,0,0,277,48009,.029605264,.023026315,.46546054,.011513158,0,0,0,.0049342103,.4555921
48,011,ARRIGORRIAGA,9695,6373,51,6322,105,6217,3322,2413,389,127,1167,37,119,70,195,42,1589,48011,.06153116,.18459348,.38168302,.02008858,.018823158,.03084467,.0066434671,.011072446,.2513445
48,015,BASAURI,34605,22013,174,21839,267,21572,12592,7557,2289,367,5971,104,427,122,696,135,3627,48015,.10481249,.27340996,.34603232,.016804799,.019552177,.03186959,.0061816019,.0055863364,.16607903
48,019,BERRIZ,3669,2455,25,2430,21,2409,1214,933,133,37,399,5,28,23,37,12,779,48019,.054732509,.16419753,.38395062,.015226337,.011522634,.015226337,.0049382718,.0094650201,.32057613
48,023,ARTEA,591,500,1,499,6,493,91,242,19,0,13,0,0,3,0,0,215,48023,.038076151,.026052104,.48496994,0,0,0,0,.0060120239,.43086171
48,024,ZEANURI,1012,850,2,848,7,841,162,407,23,7,11,1,1,0,3,3,379,48024,.027122641,.012971698,.47995284,.0082547171,.0011792453,.0035377359,.0035377359,0,.44693395
48,025,ZEBERIO,882,668,4,664,3,661,214,354,4,5,16,2,0,0,2,1,273,48025,.0060240962,.024096385,.53313255,.0075301207,0,.0030120481,.001506024,0,.41114458
48,026,DIMA,1101,908,3,905,0,905,193,350,10,6,6,3,1,2,8,4,511,48026,.011049724,.0066298344,.38674033,.0066298344,.0011049723,.0088397786,.0044198893,.0022099447,.56464088
48,027,DURANGO,21692,14798,92,14706,154,14552,6894,5821,1345,221,2068,35,164,116,294,126,4195,48027,.091459267,.14062287,.39582482,.01502788,.011151911,.019991839,.0085679311,.0078879371,.28525773
48,029,ETXEBARRI,8094,5018,39,4979,82,4897,3076,1641,481,103,1329,22,158,51,216,64,716,48029,.09660574,.26692107,.32958424,.020686885,.031733278,.043382205,.012853987,.010243021,.14380398
48,032,ELORRIO,5812,4112,30,4082,30,4052,1700,1400,265,45,422,4,14,12,67,11,1764,48032,.064919159,.10338069,.34296912,.011024008,.0034296913,.016413523,.0026947574,.0029397355,.4321411
48,034,ERMUA,13112,8281,62,8219,102,8117,4831,1598,1264,169,2913,26,270,67,408,56,1188,48034,.15379,.35442269,.19442755,.020562112,.032850713,.049641076,.006813481,.0081518432,.14454313
48,036,GALDAKAO,23963,15690,139,15551,169,15382,8273,6195,1152,327,2666,58,297,103,514,134,3779,48036,.074078836,.17143592,.39836666,.021027587,.019098449,.033052538,.0086168088,.0066233682,.24300689
48,039,GARAI,257,220,0,220,1,219,37,119,2,2,6,0,0,0,1,3,86,48039,.0090909088,.027272727,.54090911,.0090909088,0,.0045454544,.013636364,0,.39090911
48,050,IZURTZA,216,180,2,178,0,178,36,66,5,0,5,0,1,0,1,0,100,48050,.028089888,.028089888,.37078652,0,.0056179776,.0056179776,0,0,.56179774
48,055,LEMOA,2663,1991,27,1964,24,1940,672,799,65,37,139,3,14,7,27,22,804,48055,.033095721,.070773929,.4068228,.018839104,.0071283095,.013747455,.011201629,.0035641547,.40936863
48,058,MALLABIA,984,685,6,679,6,673,299,253,12,8,58,0,5,4,6,1,321,48058,.017673049,.085419737,.37260678,.011782032,.0073637702,.0088365246,.0014727541,.0058910162,.47275406
48,059,MAÑARIA,397,308,0,308,0,308,89,153,3,3,7,0,0,1,0,3,137,48059,.0097402595,.022727273,.49675325,.0097402595,0,0,.0097402595,.0032467532,.4448052
48,065,UGAO-MIRABALLES,3299,2328,27,2301,28,2273,971,1028,129,44,289,5,20,13,23,13,691,48065,.056062583,.12559757,.44676226,.01912212,.0086918734,.0099956542,.0056497175,.0056497175,.3003042
48,072,OTXANDIO,1006,797,3,794,7,787,209,284,27,3,23,0,2,0,7,0,440,48072,.034005038,.028967254,.35768262,.0037783375,.0025188916,.0088161211,0,0,.55415618
48,074,URDUÑA/ORDUÑA,3360,2407,43,2364,20,2344,953,947,172,51,229,7,15,16,38,12,832,48074,.072758034,.096869715,.40059221,.021573603,.0063451775,.016074451,.005076142,.0067681894,.35194585
48,075,OROZKO,1936,1397,28,1369,16,1353,539,742,75,9,41,3,7,6,10,16,437,48075,.054784514,.029948868,.54200149,.0065741418,.0051132212,.0073046018,.011687363,.0043827612,.3192111
48,088,UBIDE,143,116,1,115,1,114,27,29,5,0,4,0,0,0,3,0,73,48088,.043478262,.034782607,.2521739,0,0,.026086956,0,0,.63478261
48,091,ATXONDO,1162,814,8,806,11,795,348,325,26,12,68,2,4,3,7,1,344,48091,.032258064,.084367245,.40322581,.014888338,.0049627791,.0086848633,.0012406948,.0037220845,.426799
48,092,BEDIA,817,608,5,603,9,594,209,336,23,10,42,1,7,0,5,2,164,48092,.038142622,.069651738,.5572139,.016583748,.011608624,.0082918741,.0033167496,0,.27197346
48,093,AREATZA,902,713,11,702,5,697,189,315,46,7,34,0,1,1,7,4,275,48093,.065527067,.048433047,.44871795,.0099715097,.0014245014,.0099715097,.0056980057,.0014245014,.39173788
48,094,IGORRE,3278,2410,22,2388,20,2368,868,1097,48,18,112,1,8,13,16,7,1035,48094,.020100502,.046901174,.45938024,.0075376886,.0033500837,.0067001674,.0029313234,.0054438859,.43341708
48,095,ZALDIBAR,2369,1459,14,1445,15,1430,910,425,124,18,284,1,18,9,25,8,500,48095,.08581315,.19653979,.29411766,.012456748,.012456748,.017301038,.0055363323,.0062283739,.34602076
48,097,ZARATAMO,1345,897,7,890,7,883,448,351,45,15,133,1,6,2,19,11,291,48097,.050561797,.1494382,.39438203,.016853932,.0067415731,.021348314,.01235955,.002247191,.32696629
48,910,IURRETA,3057,2005,6,1999,10,1989,1052,674,172,38,397,3,15,18,24,10,623,48910,.086043023,.19859929,.33716857,.019009504,.0075037517,.012006003,.0050025014,.0090045026,.31165582
48,004,AMOROTO,326,248,0,248,2,246,78,114,0,0,2,0,0,2,1,0,127,48004,0,.0080645159,.45967743,0,0,.0040322579,0,.0080645159,.51209676
48,007,MUNITIBAR-ARBATZEGI GERRIKAITZ-,357,272,0,272,2,270,85,125,1,1,1,0,0,1,1,1,138,48007,.0036764706,.0036764706,.45955881,.0036764706,0,.0036764706,.0036764706,.0036764706,.50735295
48,010,ARRIETA,436,324,2,322,1,321,112,191,1,5,3,0,0,4,2,1,112,48010,.0031055901,.0093167704,.59316772,.015527951,0,.0062111802,.0031055901,.01242236,.34782609
48,012,BAKIO,2040,1639,14,1625,18,1607,401,895,37,14,54,0,8,17,13,8,552,48012,.022769231,.03323077,.55076921,.0086153848,.0049230768,.0080000004,.0049230768,.010461538,.33969229
48,014,BARRIKA,1195,832,3,829,9,820,363,377,59,2,77,2,6,10,18,7,255,48014,.071170084,.092882991,.45476478,.0024125453,.0072376356,.021712907,.0084439088,.012062727,.30759951
48,016,BERANGO,5178,3611,25,3586,43,3543,1567,1376,406,50,538,10,66,34,89,38,905,48016,.11321807,.15002789,.38371444,.013943112,.018404908,.024818739,.010596765,.0094813164,.25237033
48,017,BERMEO,13438,9228,31,9197,49,9148,4210,4820,159,111,495,8,12,18,72,34,3373,48017,.017288245,.053821899,.52408391,.012069153,.0013047733,.0078286398,.0036968577,.00195716,.36675003
48,018,BERRIATUA,890,626,0,626,4,622,264,258,2,8,10,3,1,1,0,1,334,48018,.0031948881,.015974442,.41214058,.012779552,.0015974441,0,.0015974441,.0015974441,.53354633
48,021,BUSTURIA,1425,1026,6,1020,14,1006,399,505,30,11,82,2,2,3,11,5,351,48021,.029411765,.08039216,.49509802,.010784314,.0019607844,.010784314,.004901961,.0029411765,.34411764
48,028,EA,755,616,1,615,5,610,139,277,4,4,4,0,0,2,1,2,315,48028,.0065040649,.0065040649,.45040649,.0065040649,0,.0016260162,.0032520324,.0032520324,.51219511
48,030,ETXEBARRIA,621,510,0,510,3,507,111,247,3,1,9,1,0,0,2,0,240,48030,.0058823531,.01764706,.48431373,.0019607844,0,.0039215689,0,0,.47058824
48,031,ELANTXOBE,353,296,0,296,1,295,57,158,2,0,0,0,1,1,1,0,131,48031,.0067567569,0,.53378379,0,.0033783785,.0033783785,0,.0033783785,.44256756
48,033,EREÑO,212,170,0,170,2,168,42,86,3,1,1,0,0,1,1,1,71,48033,.01764706,.0058823531,.50588238,.0058823531,0,.0058823531,.0058823531,.0058823531,.41764706
48,035,FRUIZ,407,320,3,317,4,313,87,172,7,3,10,0,4,3,3,2,109,48035,.02208202,.03154574,.54258674,.0094637228,.012618297,.0094637228,.0063091484,.0094637228,.34384859
48,038,GAMIZ-FIKA,1088,836,5,831,10,821,252,437,32,5,26,1,1,4,3,8,301,48038,.038507823,.031287607,.52587247,.0060168472,.0012033695,.0036101083,.0096269557,.0048134779,.36221421
48,040,GATIKA,1269,926,6,920,18,902,343,501,29,8,42,4,1,2,4,3,305,48040,.031521738,.045652173,.5445652,.0086956518,.0010869565,.0043478259,.0032608695,.0021739129,.33152175
48,041,GAUTEGIZ ARTEAGA,722,585,6,579,2,577,137,321,7,4,26,2,0,6,4,1,206,48041,.01208981,.044905007,.55440414,.0069084628,0,.0069084628,.0017271157,.010362694,.35578585
48,043,GORLIZ,4251,3033,19,3014,45,2969,1218,1516,197,37,235,11,31,32,55,35,802,48043,.065361649,.077969477,.50298607,.012276045,.010285335,.018248174,.011612475,.01061712,.26609159
48,044,GETXO,63687,45264,272,44992,593,44399,18423,16471,10864,481,5779,130,1114,418,731,529,7449,48044,.24146515,.12844506,.36608732,.01069079,.024759958,.016247332,.011757646,.0092905406,.16556276
48,046,GERNIKA-LUMO,12666,9404,56,9348,77,9271,3262,3948,342,135,761,19,43,35,100,39,3794,48046,.036585364,.081407785,.42233634,.014441592,.0045999144,.010697476,.0041720155,.0037441163,.40586221
48,047,GIZABURUAGA,161,124,0,124,2,122,37,35,0,1,0,0,0,0,0,0,86,48047,0,0,.28225806,.0080645159,0,0,0,0,.69354838
48,048,IBARRANGELU,559,424,2,422,1,421,135,207,3,1,9,0,1,4,5,0,189,48048,.0071090045,.021327015,.49052134,.0023696683,.0023696683,.011848342,0,.0094786733,.4478673
48,049,ISPASTER,560,461,0,461,0,461,99,245,6,0,1,1,3,2,2,0,200,48049,.013015185,.0021691974,.53145337,0,.0065075923,.0043383949,0,.0043383949,.43383947
48,052,LARRABETZU,1543,1238,6,1232,8,1224,305,508,33,7,24,2,5,6,13,4,619,48052,.026785715,.019480519,.41233766,.0056818184,.0040584416,.010551948,.0032467532,.0048701297,.50243509
48,053,LAUKIZ,870,659,2,657,7,650,211,358,87,4,49,0,2,1,1,4,140,48053,.13242009,.074581429,.54490107,.0060882801,.0030441401,.00152207,.0060882801,.00152207,.21308981
48,054,LEIOA,23788,15718,147,15571,241,15330,8070,6110,1889,268,2954,59,392,137,477,219,2573,48054,.12131526,.18971165,.39239612,.017211484,.025175005,.030633871,.014064607,.0087984074,.16524307
48,056,LEMOIZ,904,664,3,661,3,658,240,366,13,10,22,1,1,7,8,3,226,48056,.019667171,.033282906,.55370653,.015128593,.0015128592,.012102874,.004538578,.010590015,.34190619
48,057,LEKEITIO,5909,4501,11,4490,32,4458,1408,1850,74,22,90,5,2,7,26,7,2364,48057,.01648107,.020044543,.41202673,.0048997775,.0004454343,.0057906457,.00155902,.00155902,.52650332
48,060,MARKINA-XEMEIN,3699,2596,8,2588,13,2575,1103,1251,42,17,61,0,4,8,22,7,1149,48060,.016228748,.023570325,.48338485,.0065687788,.001545595,.0085007725,.0027047913,.00309119,.44397217
48,061,MARURI-JATABE,768,599,7,592,6,586,169,317,24,8,29,2,4,7,7,5,179,48061,.040540539,.048986487,.53547299,.013513514,.0067567569,.011824325,.0084459456,.011824325,.30236486
48,062,MENDATA,308,255,1,254,2,252,53,133,2,0,0,0,1,0,1,0,115,48062,.0078740157,0,.52362204,0,.0039370079,.0039370079,0,0,.4527559
48,063,MENDEXA,352,291,0,291,2,289,61,126,1,4,7,0,0,1,2,0,148,48063,.0034364262,.024054984,.43298969,.013745705,0,.0068728523,0,.0034364262,.50859106
48,064,MEÑAKA,599,473,2,471,3,468,126,214,9,6,8,1,1,0,0,1,226,48064,.019108281,.016985139,.45435244,.012738854,.0021231424,0,.0021231424,0,.47983015
48,066,MORGA,358,276,0,276,0,276,82,177,3,0,3,0,0,4,0,0,89,48066,.010869565,.010869565,.64130437,0,0,0,0,.014492754,.32246378
48,067,MUXIKA,1191,912,5,907,1,906,279,410,13,10,19,0,0,2,8,3,438,48067,.014332966,.020948181,.45203969,.011025358,0,.008820287,.0033076075,.0022050717,.48291069
48,068,MUNDAKA,1575,1260,4,1256,8,1248,315,747,17,10,32,0,1,5,4,3,426,48068,.013535032,.025477707,.59474522,.0079617836,.00079617836,.0031847134,.0023885351,.0039808918,.33917198
48,069,MUNGIA,12486,8729,45,8684,90,8594,3757,4548,668,125,681,20,65,55,119,39,2194,48069,.07692308,.07842008,.52372181,.014394288,.0074850298,.013703362,.0044910181,.0063334866,.25264856
48,070,AULESTI,543,407,2,405,6,399,136,135,0,0,3,0,0,0,1,0,260,48070,0,.0074074073,.33333334,0,0,.0024691359,0,0,.64197528
48,073,ONDARROA,7090,4898,27,4871,39,4832,2192,1729,169,36,147,9,7,10,36,9,2672,48073,.034695134,.030178608,.35495791,.0073906793,.0014370766,.0073906793,.0018476698,.0020529665,.54855263
48,076,SUKARRIETA,298,240,0,240,1,239,58,145,6,2,9,0,0,0,3,7,64,48076,.025,.037500001,.60416669,.0083333338,0,.0125,.029166667,0,.26666668
48,077,PLENTZIA,3386,2467,16,2451,23,2428,919,1303,185,23,174,8,22,22,30,19,615,48077,.075479396,.070991434,.53161973,.0093839252,.0089759286,.012239902,.007751938,.0089759286,.250918
48,079,ERRIGOITI,459,383,0,383,6,377,76,190,10,3,4,0,0,3,2,0,163,48079,.02610966,.010443864,.49608356,.0078328978,0,.0052219322,0,.0078328978,.42558748
48,081,LEZAMA,1906,1426,6,1420,19,1401,480,772,54,14,80,2,7,8,23,7,428,48081,.038028169,.056338027,.54366195,.0098591549,.0049295775,.016197182,.0049295775,.0056338026,.30140844
48,085,SOPELANA,9982,6898,55,6843,97,6746,3084,2816,411,95,807,33,85,86,192,77,2063,48085,.060061377,.11793073,.41151541,.0138828,.012421452,.02805787,.011252374,.012567587,.30147597
48,089,URDULIZ,2949,2151,14,2137,23,2114,798,972,120,37,222,7,26,20,46,16,624,48089,.056153487,.10388395,.45484325,.017313991,.012166589,.021525502,.0074871313,.0093589146,.29199812
48,901,DERIO,4501,3187,22,3165,50,3115,1314,1379,212,58,697,12,35,25,69,28,549,48901,.066982619,.22022116,.43570301,.018325435,.011058452,.021800948,.0088467617,.0078988941,.17345971
48,902,ERANDIO,19229,12134,105,12029,236,11793,7095,4963,874,236,2632,44,159,88,337,113,2197,48902,.072657742,.21880455,.41258624,.019619254,.013218056,.028015628,.0093939649,.0073156538,.18264195
48,903,LOIU,1915,1429,11,1418,7,1411,486,868,145,12,92,3,13,8,18,10,228,48903,.1022567,.06488011,.61212975,.0084626237,.0091678416,.012693935,.0070521859,.0056417491,.16078985
48,904,SONDIKA,3523,2645,27,2618,43,2575,878,1383,207,30,287,7,29,13,44,19,537,48904,.07906799,.10962567,.52826583,.011459129,.011077158,.016806724,.0072574485,.0049656224,.20511842
48,905,ZAMUDIO,2583,1885,31,1854,18,1836,698,907,89,34,180,3,9,7,27,14,555,48905,.048004314,.097087376,.48921251,.018338727,.004854369,.014563107,.0075512407,.0037756204,.29935277
48,906,FORUA,778,629,1,628,4,624,149,293,13,3,24,1,1,4,3,1,281,48906,.020700637,.038216561,.46656051,.0047770701,.0015923567,.0047770701,.0015923567,.0063694268,.44745222
48,907,KORTEZUBI,346,296,1,295,5,290,50,162,3,0,2,0,3,1,2,0,117,48907,.010169491,.0067796609,.54915255,0,.010169491,.0067796609,0,.0033898305,.39661017
48,908,MURUETA,243,199,3,196,1,195,44,101,3,2,3,0,2,1,0,0,83,48908,.015306123,.015306123,.51530612,.010204081,.010204081,0,0,.0051020407,.42346939
48,909,NABARNIZ,193,162,0,162,1,161,31,59,0,1,1,0,0,0,0,2,98,48909,0,.0061728396,.36419752,.0061728396,0,0,.012345679,0,.60493827
48,911,AJANGIZ,368,308,1,307,4,303,60,102,1,2,0,0,0,2,0,1,192,48911,.0032573289,0,.33224756,.0065146578,0,0,.0032573289,.0065146578,.62540716
48,914,ARRATZU,323,278,2,276,2,274,45,138,0,1,1,0,0,2,1,0,130,48914,0,.0036231885,.5,.0036231885,0,.0036231885,0,.0072463769,.4710145
48,915,ZIORTZA - BOLIBAR,364,279,1,278,1,277,85,125,3,0,4,0,0,0,0,0,144,48915,.010791367,.01438849,.44964027,0,0,0,0,0,.51798558
48,999,MUNICIPIO CERA BIZKAIA,30271,1704,24,1680,9,1671,28567,571,270,18,335,17,59,22,47,2,300,48999,.16071428,.19940476,.33988094,.010714286,.035119049,.027976191,.0011904762,.013095238,.17857143
